Proizvod;Mesec_pruzanja_usluge;Jedinicna_cena;Broj_transakcija;Fakturisan_iznos;Fakturisan_korigovan_iznos;Naplacen_iznos;Kumulativ_naplacenih_iznosa;Nenaplacen_iznos;Nenaplacen_korigovan_iznos;Storniran_iznos_u_tekucem_mesecu_iz_perioda_pracenja;Otkazan_iznos;Kumulativ_otkazanih_iznosa;Iznos_za_prenos_sredstava_;Provajder
O_1030_STOPHOT_1030HOT                  ;2024-11-01;5;5;25;25;0;25;0;0;0;0;0;0;NTHMedia_S
O_1030_STOPLET_1030LET                  ;2024-11-01;5;4;20;20;0;20;0;0;0;0;0;0;NTHMedia_S
O_1030_STOPSPA_1030SPA                  ;2024-11-01;5;1;5;5;0;5;0;0;0;0;0;0;NTHMedia_S
O_1123_STOPFV_1123FV                    ;2024-11-01;5;1;5;5;0;5;0;0;0;0;0;0;NTHMedia_S
O_1123_STOPHV_1123HV                    ;2024-11-01;5;1;5;5;0;5;0;0;0;0;0;0;NTHMedia_S
O_1123_STOPMX_1123MX                    ;2024-11-01;5;3;15;15;0;15;0;0;0;0;0;0;NTHMedia_S
O_1553_STOPGAMMA_1553GAMMA              ;2024-11-01;5;14;70;70;5;70;0;0;0;0;0;6;NTHMedia_S
O_1553_STOPHD_1553Hd                    ;2024-11-01;5;1;5;5;0;5;0;0;0;0;0;0;NTHMedia_S
O_1553_STOPOCISTI_1553OCISTI            ;2024-11-01;5;4;20;20;0;20;0;0;0;0;0;0;NTHMedia_S
O_1553_STOPTOP_1553Top                  ;2024-11-01;5;1;5;5;0;5;0;0;0;0;0;0;NTHMedia_S
O_1553_STOPXONE_1553XONE                ;2024-11-01;5;126;630;630;5;620;10;10;0;0;0;6;NTHMedia_S
O_1554_STOPAPC_1554APC                  ;2024-11-01;5;1510;7550;7550;65;7430;120;120;0;0;0;78;NTHMedia_S
O_1554_STOPEVG_1554EVG                  ;2024-11-01;5;108;540;540;10;530;10;10;0;0;0;12;NTHMedia_S
O_1554_STOPJACK_NTHJackass              ;2024-11-01;5;1;5;5;0;5;0;0;0;0;0;0;NTHMedia_S
O_1554_STOPMOV_1554MOV                  ;2024-11-01;5;2;10;10;0;10;0;0;0;0;0;0;NTHMedia_S
O_1554_STOPOK_1554OK                    ;2024-11-01;5;2;10;10;0;10;0;0;0;0;0;0;NTHMedia_S
O_1554_STOPPUSSY_NTHPussylicious        ;2024-11-01;5;1;5;5;0;5;0;0;0;0;0;0;NTHMedia_S
O_1554_STOPRRR_1554RRR                  ;2024-11-01;5;2;10;10;0;10;0;0;0;0;0;0;NTHMedia_S
O_1554_STOPTUBE_1554TUBE                ;2024-11-01;5;479;2395;2395;25;2370;25;25;0;0;0;30;NTHMedia_S
O_1556_STOPFUN_1556FUN                  ;2024-11-01;5;1;5;5;0;5;0;0;0;0;0;0;NTHMedia_S
O_1556_STOPGAMI_1556GAMI                ;2024-11-01;5;6;30;30;0;30;0;0;0;0;0;0;NTHMedia_S
O_1556_STOPRAPID_1556RAPID              ;2024-11-01;5;200;1000;1000;25;995;5;5;0;0;0;30;NTHMedia_S
O_1556_STOPTOP_1556TOP                  ;2024-11-01;5;1;5;5;0;5;0;0;0;0;0;0;NTHMedia_S
O_1617_STOPIGRE_NTHigre                 ;2024-11-01;5;1;5;5;0;5;0;0;0;0;0;0;NTHMedia_S
O_1666_STOPAKA_NTHAka                   ;2024-11-01;5;1;5;5;0;5;0;0;0;0;0;0;NTHMedia_S
O_1666_STOPGOLD1_NTHGold1               ;2024-11-01;5;1;5;5;0;5;0;0;0;0;0;0;NTHMedia_S
O_2229_STOPSAVET_2229SuperSavet         ;2024-11-01;5;1;5;5;0;5;0;0;0;0;0;0;NTHMedia_S
O_2778_STOPEROV2_2778Erov2              ;2024-11-01;5;31;155;155;0;150;5;5;0;0;0;0;NTHMedia_S
O_2778_STOPEROV3_2778Erov3              ;2024-11-01;5;6;30;30;0;25;5;5;0;0;0;0;NTHMedia_S
O_3334_STOPGEN_3334GEN                  ;2024-11-01;5;144;720;720;10;705;15;15;0;0;0;12;NTHMedia_S
O_4011_STOPBRAIN_4011BRAIN              ;2024-11-01;5;130;650;650;20;630;20;20;0;0;0;24;NTHMedia_S
O_4016_STOPOCISTI_4016OCISTI            ;2024-11-01;5;2;10;10;0;10;0;0;0;0;0;0;NTHMedia_S
O_4025_STOPFB_4025FB                    ;2024-11-01;5;3;15;15;0;15;0;0;0;0;0;0;NTHMedia_S
O_4025_STOPTH_4025TH                    ;2024-11-01;5;60;300;300;5;290;10;10;0;0;0;6;NTHMedia_S
O_4091_STOPMS_4091MS                    ;2024-11-01;5;672;3360;3360;75;3315;45;45;0;0;0;90;NTHMedia_S
O_4092_STOPASTRO_4092ASTRO              ;2024-11-01;5;2;10;10;0;10;0;0;0;0;0;0;NTHMedia_S
O_4092_STOPGAMI_4092GAMI                ;2024-11-01;5;313;1565;1565;35;1555;10;10;0;0;0;42;NTHMedia_S
O_4092_STOPM360_4092M360                ;2024-11-01;5;7;35;35;0;35;0;0;0;0;0;0;NTHMedia_S
O_4093_STOPSTREAM_4093STREAM            ;2024-11-01;5;244;1220;1220;20;1190;30;30;0;0;0;24;NTHMedia_S
O_4094_STOPABC_4094ABC                  ;2024-11-01;5;29;145;145;5;145;0;0;0;0;0;6;NTHMedia_S
O_4094_STOPHUB_4094HUB                  ;2024-11-01;5;582;2910;2910;15;2895;15;15;0;0;0;18;NTHMedia_S
O_4094_STOPIGRAJ_4094IGRAJ              ;2024-11-01;5;1;5;5;0;5;0;0;0;0;0;0;NTHMedia_S
O_4097_STOPAAA_4097AAA                  ;2024-11-01;5;2;10;10;0;10;0;0;0;0;0;0;NTHMedia_S
O_4097_STOPDF_4097DF                    ;2024-11-01;5;1;5;5;0;5;0;0;0;0;0;0;NTHMedia_S
O_4098_STOPAAA_4098AAA                  ;2024-11-01;5;1;5;5;0;5;0;0;0;0;0;0;NTHMedia_S
O_4272_STOPSM_4272SM                    ;2024-11-01;5;1435;7175;7175;110;7050;125;125;0;0;0;132;NTHMedia_S
O_4466_STOPPREUZMI_4466PREUZMI          ;2024-11-01;5;2;10;10;0;10;0;0;0;0;0;0;NTHMedia_S
O_4505_STOPAUGIE_4505AUGIE              ;2024-11-01;5;31;155;155;5;155;0;0;0;0;0;6;NTHMedia_S
O_4516_STOPASTRO_4516ASTRO              ;2024-11-01;5;3;15;15;10;10;5;5;0;0;0;12;NTHMedia_S
O_4516_STOPDANCE_4516DANCE              ;2024-11-01;5;2;10;10;0;10;0;0;0;0;0;0;NTHMedia_S
O_4516_STOPFUN_4516FUN                  ;2024-11-01;5;5;25;25;0;25;0;0;0;0;0;0;NTHMedia_S
O_4516_STOPIQ_4516IQ                    ;2024-11-01;5;8;40;40;0;40;0;0;0;0;0;0;NTHMedia_S
O_4516_STOPKLICK_4516KLICK              ;2024-11-01;5;6;30;30;0;30;0;0;0;0;0;0;NTHMedia_S
O_4516_STOPLOL_4516LOL                  ;2024-11-01;5;1;5;5;0;5;0;0;0;0;0;0;NTHMedia_S
O_4516_STOPPIC_4516PIC                  ;2024-11-01;5;35;175;175;0;165;10;10;0;0;0;0;NTHMedia_S
O_4516_STOPSPICY_4516SPICY              ;2024-11-01;5;149;745;745;20;730;15;15;0;0;0;24;NTHMedia_S
O_4557_STOPHUB_4557HUB                  ;2024-11-01;5;3;15;15;0;15;0;0;0;0;0;0;NTHMedia_S
O_4820_STOPAW_4820AW                    ;2024-11-01;5;2;10;10;0;10;0;0;0;0;0;0;NTHMedia_S
O_4822_STOPKC_4822KC                    ;2024-11-01;5;9;45;45;0;45;0;0;0;0;0;0;NTHMedia_S
O_5060_STOPFC_5060FC                    ;2024-11-01;5;415;2075;2075;15;2050;25;25;0;0;0;18;NTHMedia_S
O_5200_STOPBED_5200BED                  ;2024-11-01;5;13;65;65;5;60;5;5;0;0;0;6;NTHMedia_S
O_5200_STOPGAM_5200GAM                  ;2024-11-01;5;173;865;865;10;865;0;0;0;0;0;12;NTHMedia_S
O_5225_STOPAV_5225AV                    ;2024-11-01;5;1;5;5;0;5;0;0;0;0;0;0;NTHMedia_S
O_5225_STOPFC_5225FC                    ;2024-11-01;5;25;125;125;0;125;0;0;0;0;0;0;NTHMedia_S
O_5225_STOPGET_5225GET                  ;2024-11-01;5;9;45;45;0;45;0;0;0;0;0;0;NTHMedia_S
O_5444_STOPCF_5444CF                    ;2024-11-01;5;5;25;25;0;25;0;0;0;0;0;0;NTHMedia_S
O_5444_STOPPT_5444PT                    ;2024-11-01;5;11;55;55;5;55;0;0;0;0;0;6;NTHMedia_S
O_5522_STOPWATCH_5522WATCH              ;2024-11-01;5;11;55;55;0;55;0;0;0;0;0;0;NTHMedia_S
O_5530_STOPAPPSFACTORY_5530APPSFACTORY  ;2024-11-01;5;12;60;60;0;60;0;0;0;0;0;0;NTHMedia_S
O_5789_STOPCRZ_5789CRZ                  ;2024-11-01;5;2;10;10;0;10;0;0;0;0;0;0;NTHMedia_S
O_5791_STOPMMG_5791MMG                  ;2024-11-01;5;5;25;25;0;25;0;0;0;0;0;0;NTHMedia_S
O_5791_STOPMMV_5791MMV                  ;2024-11-01;5;3;15;15;0;15;0;0;0;0;0;0;NTHMedia_S
O_5791_STOPQCS_5791QCS                  ;2024-11-01;5;6;30;30;0;30;0;0;0;0;0;0;NTHMedia_S
O_5791_STOPUGZ_5791UGZ                  ;2024-11-01;5;6;30;30;5;30;0;0;0;0;0;6;NTHMedia_S
O_5792_STOPPFL_5792PFL                  ;2024-11-01;5;6;30;30;0;30;0;0;0;0;0;0;NTHMedia_S
O_5807_STOPBMS_5807BMS                  ;2024-11-01;5;185;925;925;5;915;10;10;0;0;0;6;NTHMedia_S
O_5807_STOPBT_5807BT                    ;2024-11-01;5;279;1395;1395;15;1380;15;15;0;0;0;18;NTHMedia_S
O_5807_STOPGYM_5807GYM                  ;2024-11-01;5;108;540;540;15;525;15;15;0;0;0;18;NTHMedia_S
O_5807_STOPYC_5807YC                    ;2024-11-01;5;348;1740;1740;20;1735;5;5;0;0;0;24;NTHMedia_S
O_7008_STOPSAT_7008Sat                  ;2024-11-01;5;1;5;5;0;5;0;0;0;0;0;0;NTHMedia_S
O_8807_STOPFIT_8807FIT                  ;2024-11-01;5;4;20;20;0;20;0;0;0;0;0;0;NTHMedia_S
O_8807_STOPHORO_8807HORO                ;2024-11-01;5;44;220;220;15;220;0;0;0;0;0;18;NTHMedia_S
O_8809_STOPSKUEEDIO_8809SKUEEDIO        ;2024-11-01;5;159;795;795;10;790;5;5;0;0;0;12;NTHMedia_S
R_1030_LET_1030LET                      ;2024-11-01;5;1;5;5;0;5;0;0;0;0;0;0;NTHMedia_S
R_1123_HV_1123HV                        ;2024-11-01;5;1;5;5;0;5;0;0;0;0;0;0;NTHMedia_S
R_1123_MV_1123MV                        ;2024-11-01;5;1;5;5;0;5;0;0;0;0;0;0;NTHMedia_S
R_1553_OCISTI_1553OCISTI                ;2024-11-01;5;1;5;5;0;5;0;0;0;0;0;0;NTHMedia_S
R_1554_AA_1554AA                        ;2024-11-01;5;1;5;5;0;5;0;0;0;0;0;0;NTHMedia_S
R_1554_MOV_1554MOV                      ;2024-11-01;5;1;5;5;0;5;0;0;0;0;0;0;NTHMedia_S
R_1554_OK_1554OK                        ;2024-11-01;5;3;15;15;0;15;0;0;0;0;0;0;NTHMedia_S
R_2229_SAVET_2229SuperSavet             ;2024-11-01;5;1;5;5;0;5;0;0;0;0;0;0;NTHMedia_S
R_2778_EROV2_2778Erov2                  ;2024-11-01;5;26;130;130;0;120;10;10;0;0;0;0;NTHMedia_S
R_2778_EROV3_2778Erov3                  ;2024-11-01;5;7;35;35;0;35;0;0;0;0;0;0;NTHMedia_S
R_4091_MS_4091MS                        ;2024-11-01;5;1;5;5;5;5;0;0;0;0;0;6;NTHMedia_S
R_4516_FUN_4516FUN                      ;2024-11-01;5;1;5;5;0;5;0;0;0;0;0;0;NTHMedia_S
R_8807_TK1_8807TK1                      ;2024-11-01;5;1;5;5;0;5;0;0;0;0;0;0;NTHMedia_S
R_8807_TK11_8807TK11                    ;2024-11-01;5;1;5;5;0;5;0;0;0;0;0;0;NTHMedia_S
R_8807_TK14_8807TK14                    ;2024-11-01;5;1;5;5;0;5;0;0;0;0;0;0;NTHMedia_S
S___1030HOT                             ;2024-11-01;150;222;33300;33300;2400;33300;0;0;0;0;0;2880;NTHMedia_S
S___1030LET                             ;2024-11-01;300;76;22800;22800;0;22800;0;0;0;0;0;0;NTHMedia_S
S___1030SPA                             ;2024-11-01;300;10;3000;3000;0;3000;0;0;0;0;0;0;NTHMedia_S
S___1123FT                              ;2024-11-01;150;23;3450;3450;0;3450;0;0;0;0;0;0;NTHMedia_S
S___1123FV                              ;2024-11-01;150;49;7350;7350;0;7350;0;0;0;0;0;0;NTHMedia_S
S___1123GA                              ;2024-11-01;150;8;1200;1200;0;1200;0;0;0;0;0;0;NTHMedia_S
S___1123HV                              ;2024-11-01;150;44;6600;6600;0;6600;0;0;0;0;0;0;NTHMedia_S
S___1123MV                              ;2024-11-01;150;186;27900;27900;0;26550;1350;1350;0;0;0;0;NTHMedia_S
S___1123MX                              ;2024-11-01;150;220;33000;33000;0;33000;0;0;0;0;0;0;NTHMedia_S
S___1518IGRA                            ;2024-11-01;150;8;1200;1200;0;1200;0;0;0;0;0;0;NTHMedia_S
S___1553GAMMA                           ;2024-11-01;300;369;110700;110700;1200;104100;6600;6600;0;0;0;1440;NTHMedia_S
S___1553Hd                              ;2024-11-01;150;74;11100;11100;0;9900;1200;1200;0;0;0;0;NTHMedia_S
S___1553OCISTI                          ;2024-11-01;300;159;47700;47700;1500;43800;3900;3900;0;0;0;1800;NTHMedia_S
S___1553VID                             ;2024-11-01;150;9;1350;1350;0;1350;0;0;0;0;0;0;NTHMedia_S
S___1553XONE                            ;2024-11-01;150;3483;522450;522450;9150;507300;15150;15150;0;0;0;10980;NTHMedia_S
S___1554AA                              ;2024-11-01;150;27;4050;4050;1350;4050;0;0;0;0;0;1620;NTHMedia_S
S___1554APC                             ;2024-11-01;300;11172;3351600;3351600;71400;3264600;87000;87000;0;0;0;85680;NTHMedia_S
S___1554EVG                             ;2024-11-01;150;362;54300;54300;1500;53850;450;450;0;0;0;1800;NTHMedia_S
S___1554FB                              ;2024-11-01;300;15;4500;4500;0;4500;0;0;0;0;0;0;NTHMedia_S
S___1554Gutanje                         ;2024-11-01;150;3;450;450;0;450;0;0;0;0;0;0;NTHMedia_S
S___1554Hit                             ;2024-11-01;150;5;750;750;0;750;0;0;0;0;0;0;NTHMedia_S
S___1554Horny                           ;2024-11-01;150;7;1050;1050;0;1050;0;0;0;0;0;0;NTHMedia_S
S___1554JPLAY                           ;2024-11-01;150;19;2850;2850;0;2850;0;0;0;0;0;0;NTHMedia_S
S___1554MOV                             ;2024-11-01;150;158;23700;23700;0;23700;0;0;0;0;0;0;NTHMedia_S
S___1554Puta                            ;2024-11-01;150;5;750;750;0;750;0;0;0;0;0;0;NTHMedia_S
S___1554RRR                             ;2024-11-01;150;584;87600;87600;1350;85200;2400;2400;0;0;0;1620;NTHMedia_S
S___1554Selfi                           ;2024-11-01;150;4;600;600;0;600;0;0;0;0;0;0;NTHMedia_S
S___1554Sise                            ;2024-11-01;150;7;1050;1050;0;1050;0;0;0;0;0;0;NTHMedia_S
S___1554Top                             ;2024-11-01;150;4;600;600;0;600;0;0;0;0;0;0;NTHMedia_S
S___1554TUBE                            ;2024-11-01;150;4363;654450;654450;8400;639000;15450;15450;0;0;0;10080;NTHMedia_S
S___1554UGZ                             ;2024-11-01;300;4;1200;1200;0;1200;0;0;0;0;0;0;NTHMedia_S
S___1554VID                             ;2024-11-01;300;17;5100;5100;0;5100;0;0;0;0;0;0;NTHMedia_S
S___1554Vruca                           ;2024-11-01;150;2;300;300;0;300;0;0;0;0;0;0;NTHMedia_S
S___1554XPORN                           ;2024-11-01;150;9;1350;1350;0;1350;0;0;0;0;0;0;NTHMedia_S
S___1556CRZ                             ;2024-11-01;150;41;6150;6150;0;4800;1350;1350;0;0;0;0;NTHMedia_S
S___1556PLAY                            ;2024-11-01;300;42;12600;12600;0;11700;900;900;0;0;0;0;NTHMedia_S
S___1556RAPID                           ;2024-11-01;150;4509;676350;676350;17250;660450;15900;15900;0;0;0;20700;NTHMedia_S
S___1556TOP                             ;2024-11-01;300;4;1200;1200;0;0;1200;1200;0;0;0;0;NTHMedia_S
S___1617NTHDomace                       ;2024-11-01;150;152;22800;22800;1200;22800;0;0;0;0;0;1440;NTHMedia_S
S___2229BusWapLand                      ;2024-11-01;80;4;320;320;0;320;0;0;0;0;0;0;NTHMedia_S
S___2229DnevniHoroskop                  ;2024-11-01;15;2;30;30;0;30;0;0;0;0;0;0;NTHMedia_S
S___2229SuperSavet                      ;2024-11-01;150;4;600;600;0;600;0;0;0;0;0;0;NTHMedia_S
S___2229TXTMania                        ;2024-11-01;15;726;10890;10890;105;10770;120;120;0;0;0;126;NTHMedia_S
S___2229WapLandClub                     ;2024-11-01;90;133;11970;11970;180;11700;270;270;0;0;0;216;NTHMedia_S
S___2229WapLandClub18                   ;2024-11-01;50;4;200;200;0;200;0;0;0;0;0;0;NTHMedia_S
S___2229WapLandClub19                   ;2024-11-01;75;4;300;300;0;300;0;0;0;0;0;0;NTHMedia_S
S___2229WapLandKids11                   ;2024-11-01;90;57;5130;5130;0;5130;0;0;0;0;0;0;NTHMedia_S
S___2229WapLandKids27                   ;2024-11-01;150;12;1800;1800;0;1800;0;0;0;0;0;0;NTHMedia_S
S___2232FTV                             ;2024-11-01;150;5;750;750;0;750;0;0;0;0;0;0;NTHMedia_S
S___2345sedmica                         ;2024-11-01;35;4;140;140;0;140;0;0;0;0;0;0;NTHMedia_S
S___2778Erov2                           ;2024-11-01;300;50;15000;15000;900;13800;1200;1200;0;0;0;1080;NTHMedia_S
S___2778Erov3                           ;2024-11-01;500;9;4500;4500;0;3500;1000;1000;0;0;0;0;NTHMedia_S
S___3334GEN                             ;2024-11-01;150;490;73500;73500;1350;72000;1500;1500;0;0;0;1620;NTHMedia_S
S___4011BRAIN                           ;2024-11-01;150;2751;412650;412650;12450;392250;20400;20400;0;0;0;14940;NTHMedia_S
S___4011MEMO                            ;2024-11-01;150;8;1200;1200;0;1200;0;0;0;0;0;0;NTHMedia_S
S___4014HID                             ;2024-11-01;300;26;7800;7800;0;7800;0;0;0;0;0;0;NTHMedia_S
S___4016OCISTI                          ;2024-11-01;300;81;24300;24300;0;18300;6000;6000;0;0;0;0;NTHMedia_S
S___4025FB                              ;2024-11-01;150;319;47850;47850;0;46500;1350;1350;0;0;0;0;NTHMedia_S
S___4025TH                              ;2024-11-01;300;320;96000;96000;300;93900;2100;2100;0;0;0;360;NTHMedia_S
S___4091MS                              ;2024-11-01;300;6688;2006400;2006400;49800;1950000;56400;56400;0;0;0;59760;NTHMedia_S
S___4092ASTRO                           ;2024-11-01;300;101;30300;30300;0;27900;2400;2400;0;0;0;0;NTHMedia_S
S___4092GAMI                            ;2024-11-01;300;1748;524400;524400;8700;508800;15600;15600;0;0;0;10440;NTHMedia_S
S___4092M360                            ;2024-11-01;300;575;172500;172500;4800;166200;6300;6300;0;0;0;5760;NTHMedia_S
S___4093STREAM                          ;2024-11-01;150;1889;283350;283350;6150;274650;8700;8700;0;0;0;7380;NTHMedia_S
S___4094ABC                             ;2024-11-01;150;498;74700;74700;300;74700;0;0;0;0;0;360;NTHMedia_S
S___4094HUB                             ;2024-11-01;150;8087;1213050;1213050;15600;1180800;32250;32250;0;0;0;18720;NTHMedia_S
S___4272SM                              ;2024-11-01;300;8841;2652300;2652300;57900;2583600;68700;68700;0;0;0;69480;NTHMedia_S
S___4505AUGIE                           ;2024-11-01;300;68;20400;20400;300;20100;300;300;0;0;0;360;NTHMedia_S
S___4514AA                              ;2024-11-01;150;9;1350;1350;0;1350;0;0;0;0;0;0;NTHMedia_S
S___4514BA                              ;2024-11-01;300;4;1200;1200;0;1200;0;0;0;0;0;0;NTHMedia_S
S___4514CLUBEX                          ;2024-11-01;150;7;1050;1050;0;1050;0;0;0;0;0;0;NTHMedia_S
S___4516ASTRO                           ;2024-11-01;150;95;14250;14250;450;12600;1650;1650;0;0;0;540;NTHMedia_S
S___4516CLEAN                           ;2024-11-01;150;32;4800;4800;0;4800;0;0;0;0;0;0;NTHMedia_S
S___4516DANCE                           ;2024-11-01;150;119;17850;17850;2700;17850;0;0;0;0;0;3240;NTHMedia_S
S___4516IQ                              ;2024-11-01;150;816;122400;122400;3600;116850;5550;5550;0;0;0;4320;NTHMedia_S
S___4516KLICK                           ;2024-11-01;150;492;73800;73800;1500;71850;1950;1950;0;0;0;1800;NTHMedia_S
S___4516LOL                             ;2024-11-01;150;62;9300;9300;0;7500;1800;1800;0;0;0;0;NTHMedia_S
S___4516LUNA                            ;2024-11-01;150;20;3000;3000;0;3000;0;0;0;0;0;0;NTHMedia_S
S___4516PIC                             ;2024-11-01;150;779;116850;116850;0;114750;2100;2100;0;0;0;0;NTHMedia_S
S___4516SPICY                           ;2024-11-01;150;2433;364950;364950;7650;356250;8700;8700;0;0;0;9180;NTHMedia_S
S___4516WELL                            ;2024-11-01;150;147;22050;22050;0;20850;1200;1200;0;0;0;0;NTHMedia_S
S___4516WOW                             ;2024-11-01;150;110;16500;16500;0;13500;3000;3000;0;0;0;0;NTHMedia_S
S___4557HUB                             ;2024-11-01;150;309;46350;46350;150;44400;1950;1950;0;0;0;180;NTHMedia_S
S___4800FB                              ;2024-11-01;150;34;5100;5100;0;5100;0;0;0;0;0;0;NTHMedia_S
S___4800ON                              ;2024-11-01;150;4;600;600;0;600;0;0;0;0;0;0;NTHMedia_S
S___4820AW                              ;2024-11-01;150;565;84750;84750;5100;79800;4950;4950;0;0;0;6120;NTHMedia_S
S___4822KC                              ;2024-11-01;300;43;12900;12900;0;12300;600;600;0;0;0;0;NTHMedia_S
S___5060FC                              ;2024-11-01;300;1904;571200;571200;8100;553800;17400;17400;0;0;0;9720;NTHMedia_S
S___5200BED                             ;2024-11-01;300;23;6900;6900;300;6600;300;300;0;0;0;360;NTHMedia_S
S___5200GAM                             ;2024-11-01;150;2974;446100;446100;11250;437700;8400;8400;0;0;0;13500;NTHMedia_S
S___5225AP                              ;2024-11-01;150;123;18450;18450;0;14850;3600;3600;0;0;0;0;NTHMedia_S
S___5225FC                              ;2024-11-01;150;4823;723450;723450;16650;691350;32100;32100;0;0;0;19980;NTHMedia_S
S___5225GET                             ;2024-11-01;300;904;271200;271200;8400;257100;14100;14100;0;0;0;10080;NTHMedia_S
S___5444CF                              ;2024-11-01;300;949;284700;284700;12600;273000;11700;11700;0;0;0;15120;NTHMedia_S
S___5444PT                              ;2024-11-01;300;1086;325800;325800;4500;306300;19500;19500;0;0;0;5400;NTHMedia_S
S___5522WATCH                           ;2024-11-01;300;20;6000;6000;0;5100;900;900;0;0;0;0;NTHMedia_S
S___5530APPSFACTORY                     ;2024-11-01;150;267;40050;40050;1200;39750;300;300;0;0;0;1440;NTHMedia_S
S___5530FUN                             ;2024-11-01;150;16;2400;2400;0;2400;0;0;0;0;0;0;NTHMedia_S
S___5530GAMESBOX                        ;2024-11-01;150;19;2850;2850;0;2850;0;0;0;0;0;0;NTHMedia_S
S___5789CRZ                             ;2024-11-01;150;121;18150;18150;0;18150;0;0;0;0;0;0;NTHMedia_S
S___5791MMG                             ;2024-11-01;300;377;113100;113100;4800;104400;8700;8700;0;0;0;5760;NTHMedia_S
S___5791MMV                             ;2024-11-01;300;307;92100;92100;7500;86100;6000;6000;0;0;0;9000;NTHMedia_S
S___5791QCS                             ;2024-11-01;300;315;94500;94500;1500;86100;8400;8400;0;0;0;1800;NTHMedia_S
S___5791UGZ                             ;2024-11-01;300;419;125700;125700;1200;110700;15000;15000;0;0;0;1440;NTHMedia_S
S___5792PFL                             ;2024-11-01;300;41;12300;12300;0;12300;0;0;0;0;0;0;NTHMedia_S
S___5807BMS                             ;2024-11-01;150;3605;540750;540750;8850;525900;14850;14850;0;0;0;10620;NTHMedia_S
S___5807BT                              ;2024-11-01;150;5734;860100;860100;5400;842100;18000;18000;0;0;0;6480;NTHMedia_S
S___5807GYM                             ;2024-11-01;150;1440;216000;216000;2700;211950;4050;4050;0;0;0;3240;NTHMedia_S
S___5807YC                              ;2024-11-01;150;8096;1214400;1214400;24300;1197150;17250;17250;0;0;0;29160;NTHMedia_S
S___7008Sat                             ;2024-11-01;150;16;2400;2400;0;2400;0;0;0;0;0;0;NTHMedia_S
S___7008Sex                             ;2024-11-01;150;8;1200;1200;0;1200;0;0;0;0;0;0;NTHMedia_S
S___8807FIT                             ;2024-11-01;300;33;9900;9900;0;8700;1200;1200;0;0;0;0;NTHMedia_S
S___8807HORO                            ;2024-11-01;300;166;49800;49800;1500;48600;1200;1200;0;0;0;1800;NTHMedia_S
S___8807TK1                             ;2024-11-01;50;5;250;250;0;250;0;0;0;0;0;0;NTHMedia_S
S___8807TK10                            ;2024-11-01;50;9;450;450;0;450;0;0;0;0;0;0;NTHMedia_S
S___8807TK13                            ;2024-11-01;50;102;5100;5100;450;5100;0;0;0;0;0;540;NTHMedia_S
S___8807TK14                            ;2024-11-01;50;8;400;400;0;400;0;0;0;0;0;0;NTHMedia_S
S___8807TK2                             ;2024-11-01;50;37;1850;1850;900;1850;0;0;0;0;0;1080;NTHMedia_S
S___8809SKUEEDIO                        ;2024-11-01;300;318;95400;95400;1500;94800;600;600;0;0;0;1800;NTHMedia_S
S___GRAND                               ;2024-11-01;50;176;8800;8800;0;8800;0;0;0;0;0;0;NTHMedia_S
S___NTHfun1666                          ;2024-11-01;300;38;11400;11400;0;10200;1200;1200;0;0;0;0;NTHMedia_S
S___NTHigre                             ;2024-11-01;300;3;900;900;0;900;0;0;0;0;0;0;NTHMedia_S
S_1030_FUK_1030FUK                      ;2024-11-01;750;14;10500;10500;0;10500;0;0;0;0;0;0;NTHMedia_S
S_1441__NthChat                         ;2024-11-01;150;1257;188550;188550;7800;181650;6900;6900;0;0;0;9360;NTHMedia_S
S_1553_BAL_1553BAL                      ;2024-11-01;150;37;5550;5550;0;4950;600;600;0;0;0;0;NTHMedia_S
S_1553_ISTINA_1553ISTINA                ;2024-11-01;150;4;600;600;0;600;0;0;0;0;0;0;NTHMedia_S
S_1553_KUL_KUL                          ;2024-11-01;100;4;400;400;0;400;0;0;0;0;0;0;NTHMedia_S
S_1553_KZV_1553KZV                      ;2024-11-01;300;1677;503100;503100;11700;495900;7200;7200;0;0;0;14040;NTHMedia_S
S_1554_DAP_1554DAP                      ;2024-11-01;150;1;150;150;0;150;0;0;0;0;0;0;NTHMedia_S
S_1554_TKN_1554TKN                      ;2024-11-01;300;294;88200;88200;4800;87600;600;600;0;0;0;5760;NTHMedia_S
S_1554_VIA_1554VIA                      ;2024-11-01;600;1084;650400;650400;11400;633000;17400;17400;0;0;0;13680;NTHMedia_S
S_1556_DA_1556DA                        ;2024-11-01;5;1;5;5;0;5;0;0;0;0;0;0;NTHMedia_S
S_1556_TAT1_1556TAT1                    ;2024-11-01;200;11;2200;2200;0;2200;0;0;0;0;0;0;NTHMedia_S
S_1556_TAT2_1556TAT2                    ;2024-11-01;300;245;73500;73500;8100;73500;0;0;0;0;0;9720;NTHMedia_S
S_1556_TLS1_1556TLS1                    ;2024-11-01;100;95;9500;9500;0;9300;200;200;0;0;0;0;NTHMedia_S
S_1556_TLS2_1556TLS2                    ;2024-11-01;150;12;1800;1800;0;1800;0;0;0;0;0;0;NTHMedia_S
S_1556_TLS3_1556TLS3                    ;2024-11-01;200;49;9800;9800;0;9800;0;0;0;0;0;0;NTHMedia_S
S_1556_TLS4_1556TLS4                    ;2024-11-01;300;93;27900;27900;300;27900;0;0;0;0;0;360;NTHMedia_S
S_1556_TLS5_1556TLS5                    ;2024-11-01;150;34;5100;5100;150;5100;0;0;0;0;0;180;NTHMedia_S
S_1556_TLS6_1556TLS6                    ;2024-11-01;300;4;1200;1200;0;1200;0;0;0;0;0;0;NTHMedia_S
S_1617_SEX_1617SEX                      ;2024-11-01;750;23;17250;17250;0;15750;1500;1500;0;0;0;0;NTHMedia_S
S_1617_TIK_1617TIK                      ;2024-11-01;750;2;1500;1500;0;750;750;750;0;0;0;0;NTHMedia_S
S_1665_SYM_1665SYM                      ;2024-11-01;450;17;7650;7650;0;7650;0;0;0;0;0;0;NTHMedia_S
S_1668_AKTIVIRAJ_1668AKTIVIRAJ          ;2024-11-01;1250;27;33750;33750;0;30000;3750;3750;0;0;0;0;NTHMedia_S
S_2778_ANDEO_2778ANDEO                  ;2024-11-01;450;67;30150;30150;1350;28350;1800;1800;0;0;0;1620;NTHMedia_S
S_2778_CODE_2778CODE                    ;2024-11-01;75;3;225;225;0;225;0;0;0;0;0;0;NTHMedia_S
S_2778_DAPA_2778DAPA                    ;2024-11-01;500;12;6000;6000;0;6000;0;0;0;0;0;0;NTHMedia_S
S_2778_GO_2778GO                        ;2024-11-01;180;45;8100;8100;0;5580;2520;2520;0;0;0;0;NTHMedia_S
S_2778_KEY_2778KEY                      ;2024-11-01;400;3;1200;1200;0;1200;0;0;0;0;0;0;NTHMedia_S
S_2778_LEN_2778LEN                      ;2024-11-01;450;13;5850;5850;0;5850;0;0;0;0;0;0;NTHMedia_S
S_2778_PIN_2778PIN                      ;2024-11-01;800;13;10400;10400;0;10400;0;0;0;0;0;0;NTHMedia_S
S_2778_REKVIZIT_2778REKVIZIT            ;2024-11-01;75;114;8550;8550;0;8550;0;0;0;0;0;0;NTHMedia_S
S_4023_MILICA_4023MILICA                ;2024-11-01;250;4;1000;1000;0;1000;0;0;0;0;0;0;NTHMedia_S
S_4023_PEDJA_4023PEDJA                  ;2024-11-01;250;3;750;750;0;750;0;0;0;0;0;0;NTHMedia_S
S_4023_SAVET_4023SAVET                  ;2024-11-01;250;11;2750;2750;0;2750;0;0;0;0;0;0;NTHMedia_S
S_4505_APEX_4505APEX                    ;2024-11-01;800;156;124800;124800;1600;123200;1600;1600;0;0;0;1920;NTHMedia_S
S_4640_PCA_4640PCA                      ;2024-11-01;5;87;435;435;0;415;20;20;0;0;0;0;NTHMedia_S
S_4640_UCA_4640UCA                      ;2024-11-01;5;1;5;5;0;5;0;0;0;0;0;0;NTHMedia_S
S_4644_100_4644100                      ;2024-11-01;100;26;2600;2600;0;2600;0;0;0;0;0;0;NTHMedia_S
S_4644_150_4644150                      ;2024-11-01;150;24;3600;3600;150;3600;0;0;0;0;0;180;NTHMedia_S
S_4644_200_4644200                      ;2024-11-01;200;41;8200;8200;0;8200;0;0;0;0;0;0;NTHMedia_S
S_4644_25_464425                        ;2024-11-01;25;5;125;125;0;125;0;0;0;0;0;0;NTHMedia_S
S_4644_300_4644300                      ;2024-11-01;300;16;4800;4800;0;4800;0;0;0;0;0;0;NTHMedia_S
S_4644_50_464450                        ;2024-11-01;50;26;1300;1300;0;1050;250;250;0;0;0;0;NTHMedia_S
S_4644_GAME_4644GAME                    ;2024-11-01;50;5;250;250;0;250;0;0;0;0;0;0;NTHMedia_S
S_4644_GAME1_4644GAME1                  ;2024-11-01;100;2;200;200;0;100;100;100;0;0;0;0;NTHMedia_S
S_4644_GAME2_4644GAME2                  ;2024-11-01;150;412;61800;61800;1200;60300;1500;1500;0;0;0;1440;NTHMedia_S
S_4644_GAME3_4644GAME3                  ;2024-11-01;200;4;800;800;0;800;0;0;0;0;0;0;NTHMedia_S
S_4644_GAME4_4644GAME4                  ;2024-11-01;300;1;300;300;0;300;0;0;0;0;0;0;NTHMedia_S
S_4644_MAD_4644MAD                      ;2024-11-01;580;2;1160;1160;0;1160;0;0;0;0;0;0;NTHMedia_S
S_4644_MAT_4644MAT                      ;2024-11-01;580;64;37120;37120;580;37120;0;0;0;0;0;696;NTHMedia_S
S_4644_TXT_4644TXT                      ;2024-11-01;800;18;14400;14400;1600;14400;0;0;0;0;0;1920;NTHMedia_S
S_5232_SLA_5232SLA                      ;2024-11-01;150;934;140100;140100;3150;136950;3150;3150;0;0;0;3780;NTHMedia_S
S_5232_SLA1_5232SLA1                    ;2024-11-01;200;467;93400;93400;3200;91800;1600;1600;0;0;0;3840;NTHMedia_S
S_5232_SLA2_5232SLA2                    ;2024-11-01;300;235;70500;70500;0;69600;900;900;0;0;0;0;NTHMedia_S
S_5232_SLA3_5232SLA3                    ;2024-11-01;580;91;52780;52780;580;49880;2900;2900;0;0;0;696;NTHMedia_S
S_5232_SLA4_5232SLA4                    ;2024-11-01;800;47;37600;37600;800;36000;1600;1600;0;0;0;960;NTHMedia_S
S_5332_RATE_5332SmsRateUnicredit        ;2024-11-01;6;4221;25326;25326;378;25062;264;264;0;0;0;453.6;NTHMedia_S
S_5332_STA_5332UnicreditUpitStanja      ;2024-11-01;6;1352;8112;8112;66;8088;24;24;0;0;0;79.2;NTHMedia_S
S_7006__762chat                         ;2024-11-01;45;1;45;45;0;45;0;0;0;0;0;0;NTHMedia_S
S_7008_TAROT247_NTHTarot247             ;2024-11-01;50;6;300;300;50;300;0;0;0;0;0;60;NTHMedia_S
O_1030_STOPLET_1030LET                  ;2024-12-01;5;4;20;20;0;15;5;5;0;0;0;0;NTHMedia_S
O_1030_STOPSPA_1030SPA                  ;2024-12-01;5;1;5;5;0;5;0;0;0;0;0;0;NTHMedia_S
O_1123_STOPMV_1123MV                    ;2024-12-01;5;3;15;15;0;15;0;0;0;0;0;0;NTHMedia_S
O_1123_STOPMX_1123MX                    ;2024-12-01;5;1;5;5;0;5;0;0;0;0;0;0;NTHMedia_S
O_1553_STOPGAMMA_1553GAMMA              ;2024-12-01;5;20;100;100;15;100;0;0;0;0;0;18;NTHMedia_S
O_1553_STOPGET_1553GET                  ;2024-12-01;5;1;5;5;0;0;5;5;0;0;0;0;NTHMedia_S
O_1553_STOPGOO_1553GOO                  ;2024-12-01;5;1;5;5;5;5;0;0;0;0;0;6;NTHMedia_S
O_1553_STOPMEV_1553Mev                  ;2024-12-01;5;2;10;10;0;10;0;0;0;0;0;0;NTHMedia_S
O_1553_STOPOCISTI_1553OCISTI            ;2024-12-01;5;4;20;20;0;20;0;0;0;0;0;0;NTHMedia_S
O_1553_STOPTOP_1553Top                  ;2024-12-01;5;1;5;5;0;5;0;0;0;0;0;0;NTHMedia_S
O_1553_STOPXONE_1553XONE                ;2024-12-01;5;107;535;535;70;490;45;45;0;0;0;84;NTHMedia_S
O_1554_STOPAPC_1554APC                  ;2024-12-01;5;1768;8840;8840;1040;8510;330;330;0;0;0;1248;NTHMedia_S
O_1554_STOPEVG_1554EVG                  ;2024-12-01;5;108;540;540;75;520;20;20;0;0;0;90;NTHMedia_S
O_1554_STOPMOV_1554MOV                  ;2024-12-01;5;2;10;10;5;10;0;0;0;0;0;6;NTHMedia_S
O_1554_STOPMS_1554MS                    ;2024-12-01;5;1;5;5;0;5;0;0;0;0;0;0;NTHMedia_S
O_1554_STOPOK_1554OK                    ;2024-12-01;5;4;20;20;5;20;0;0;0;0;0;6;NTHMedia_S
O_1554_STOPRRR_1554RRR                  ;2024-12-01;5;2;10;10;5;10;0;0;0;0;0;6;NTHMedia_S
O_1554_STOPTONE_1554TONE                ;2024-12-01;5;1;5;5;0;5;0;0;0;0;0;0;NTHMedia_S
O_1554_STOPTUBE_1554TUBE                ;2024-12-01;5;407;2035;2035;340;1945;90;90;0;0;0;408;NTHMedia_S
O_1554_STOPUGZ_1554UGZ                  ;2024-12-01;5;3;15;15;10;15;0;0;0;0;0;12;NTHMedia_S
O_1556_STOPAE_1556AE                    ;2024-12-01;5;1;5;5;0;5;0;0;0;0;0;0;NTHMedia_S
O_1556_STOPPLAY_1556PLAY                ;2024-12-01;5;2;10;10;0;10;0;0;0;0;0;0;NTHMedia_S
O_1556_STOPRAPID_1556RAPID              ;2024-12-01;5;98;490;490;85;475;15;15;0;0;0;102;NTHMedia_S
O_1617_STOPDOMACE_1617NTHDomace         ;2024-12-01;5;3;15;15;0;15;0;0;0;0;0;0;NTHMedia_S
O_1666_STOPFUN_NTHfun1666               ;2024-12-01;5;1;5;5;0;5;0;0;0;0;0;0;NTHMedia_S
O_2229_STOPVIDEO_2229WapLandClub        ;2024-12-01;5;1;5;5;5;5;0;0;0;0;0;6;NTHMedia_S
O_2778_STOPEROV2_2778Erov2              ;2024-12-01;5;23;115;115;20;110;5;5;0;0;0;24;NTHMedia_S
O_2778_STOPEROV3_2778Erov3              ;2024-12-01;5;3;15;15;5;10;5;5;0;0;0;6;NTHMedia_S
O_3334_STOPGEN_3334GEN                  ;2024-12-01;5;401;2005;2005;405;1950;55;55;0;0;0;486;NTHMedia_S
O_4011_STOPBRAIN_4011BRAIN              ;2024-12-01;5;180;900;900;110;860;40;40;0;0;0;132;NTHMedia_S
O_4014_STOPHID_4014HID                  ;2024-12-01;5;1;5;5;0;5;0;0;0;0;0;0;NTHMedia_S
O_4025_STOPFB_4025FB                    ;2024-12-01;5;3;15;15;5;15;0;0;0;0;0;6;NTHMedia_S
O_4025_STOPTH_4025TH                    ;2024-12-01;5;20;100;100;20;100;0;0;0;0;0;24;NTHMedia_S
O_4091_STOPMS_4091MS                    ;2024-12-01;5;919;4595;4595;580;4455;140;140;0;0;0;696;NTHMedia_S
O_4092_STOPASTRO_4092ASTRO              ;2024-12-01;5;1;5;5;0;5;0;0;0;0;0;0;NTHMedia_S
O_4092_STOPGAMI_4092GAMI                ;2024-12-01;5;288;1440;1440;280;1390;50;50;0;0;0;336;NTHMedia_S
O_4092_STOPM360_4092M360                ;2024-12-01;5;7;35;35;0;30;5;5;0;0;0;0;NTHMedia_S
O_4093_STOPSTREAM_4093STREAM            ;2024-12-01;5;421;2105;2105;310;2035;70;70;0;0;0;372;NTHMedia_S
O_4094_STOPABC_4094ABC                  ;2024-12-01;5;12;60;60;5;60;0;0;0;0;0;6;NTHMedia_S
O_4094_STOPHUB_4094HUB                  ;2024-12-01;5;624;3120;3120;390;3020;100;100;0;0;0;468;NTHMedia_S
O_4094_STOPIGRAJ_4094IGRAJ              ;2024-12-01;5;1;5;5;0;5;0;0;0;0;0;0;NTHMedia_S
O_4098_STOPAAA_4098AAA                  ;2024-12-01;5;3;15;15;0;15;0;0;0;0;0;0;NTHMedia_S
O_4272_STOPSM_4272SM                    ;2024-12-01;5;1142;5710;5710;645;5550;160;160;0;0;0;774;NTHMedia_S
O_4466_STOPPREUZMI_4466PREUZMI          ;2024-12-01;5;1;5;5;0;5;0;0;0;0;0;0;NTHMedia_S
O_4505_STOPAUGIE_4505AUGIE              ;2024-12-01;5;248;1240;1240;130;1160;80;80;0;0;0;156;NTHMedia_S
O_4514_STOPCLUBEX_4514CLUBEX            ;2024-12-01;5;1;5;5;0;5;0;0;0;0;0;0;NTHMedia_S
O_4516_STOPASTRO_4516ASTRO              ;2024-12-01;5;2;10;10;0;10;0;0;0;0;0;0;NTHMedia_S
O_4516_STOPDANCE_4516DANCE              ;2024-12-01;5;1;5;5;0;5;0;0;0;0;0;0;NTHMedia_S
O_4516_STOPFUN_4516FUN                  ;2024-12-01;5;3;15;15;5;10;5;5;0;0;0;6;NTHMedia_S
O_4516_STOPIQ_4516IQ                    ;2024-12-01;5;4;20;20;5;20;0;0;0;0;0;6;NTHMedia_S
O_4516_STOPKLICK_4516KLICK              ;2024-12-01;5;5;25;25;0;25;0;0;0;0;0;0;NTHMedia_S
O_4516_STOPPIC_4516PIC                  ;2024-12-01;5;176;880;880;150;855;25;25;0;0;0;180;NTHMedia_S
O_4516_STOPSPICY_4516SPICY              ;2024-12-01;5;38;190;190;55;190;0;0;0;0;0;66;NTHMedia_S
O_4557_STOPHUB_4557HUB                  ;2024-12-01;5;6;30;30;5;25;5;5;0;0;0;6;NTHMedia_S
O_4820_STOPAW_4820AW                    ;2024-12-01;5;74;370;370;45;360;10;10;0;0;0;54;NTHMedia_S
O_4822_STOPKC_4822KC                    ;2024-12-01;5;37;185;185;25;170;15;15;0;0;0;30;NTHMedia_S
O_5060_STOPFC_5060FC                    ;2024-12-01;5;643;3215;3215;390;3160;55;55;0;0;0;468;NTHMedia_S
O_5200_STOPBED_5200BED                  ;2024-12-01;5;27;135;135;15;135;0;0;0;0;0;18;NTHMedia_S
O_5200_STOPGAM_5200GAM                  ;2024-12-01;5;107;535;535;85;525;10;10;0;0;0;102;NTHMedia_S
O_5225_STOPFC_5225FC                    ;2024-12-01;5;22;110;110;5;95;15;15;0;0;0;6;NTHMedia_S
O_5225_STOPGET_5225GET                  ;2024-12-01;5;11;55;55;10;50;5;5;0;0;0;12;NTHMedia_S
O_5444_STOPCF_5444CF                    ;2024-12-01;5;8;40;40;5;35;5;5;0;0;0;6;NTHMedia_S
O_5444_STOPPT_5444PT                    ;2024-12-01;5;12;60;60;15;55;5;5;0;0;0;18;NTHMedia_S
O_5522_STOPWATCH_5522WATCH              ;2024-12-01;5;7;35;35;0;35;0;0;0;0;0;0;NTHMedia_S
O_5530_STOPAPPSFACTORY_5530APPSFACTORY  ;2024-12-01;5;3;15;15;0;15;0;0;0;0;0;0;NTHMedia_S
O_5530_STOPFUN_5530FUN                  ;2024-12-01;5;1;5;5;0;5;0;0;0;0;0;0;NTHMedia_S
O_5789_STOPCRZ_5789CRZ                  ;2024-12-01;5;2;10;10;0;10;0;0;0;0;0;0;NTHMedia_S
O_5791_STOPMMG_5791MMG                  ;2024-12-01;5;8;40;40;5;40;0;0;0;0;0;6;NTHMedia_S
O_5791_STOPMMV_5791MMV                  ;2024-12-01;5;4;20;20;5;10;10;10;0;0;0;6;NTHMedia_S
O_5791_STOPQCS_5791QCS                  ;2024-12-01;5;5;25;25;5;25;0;0;0;0;0;6;NTHMedia_S
O_5791_STOPUGZ_5791UGZ                  ;2024-12-01;5;9;45;45;5;30;15;15;0;0;0;6;NTHMedia_S
O_5792_STOPPFL_5792PFL                  ;2024-12-01;5;19;95;95;20;95;0;0;0;0;0;24;NTHMedia_S
O_5807_STOPBMS_5807BMS                  ;2024-12-01;5;118;590;590;40;570;20;20;0;0;0;48;NTHMedia_S
O_5807_STOPBT_5807BT                    ;2024-12-01;5;190;950;950;65;945;5;5;0;0;0;78;NTHMedia_S
O_5807_STOPGYM_5807GYM                  ;2024-12-01;5;48;240;240;10;235;5;5;0;0;0;12;NTHMedia_S
O_5807_STOPYC_5807YC                    ;2024-12-01;5;164;820;820;95;790;30;30;0;0;0;114;NTHMedia_S
O_8807_STOPFIT_8807FIT                  ;2024-12-01;5;56;280;280;40;280;0;0;0;0;0;48;NTHMedia_S
O_8807_STOPHORO_8807HORO                ;2024-12-01;5;54;270;270;60;255;15;15;0;0;0;72;NTHMedia_S
O_8809_STOPSKUEEDIO_8809SKUEEDIO        ;2024-12-01;5;382;1910;1910;200;1800;110;110;0;0;0;240;NTHMedia_S
R_1123_FV_1123FV                        ;2024-12-01;5;1;5;5;0;5;0;0;0;0;0;0;NTHMedia_S
R_1554_MOV_1554MOV                      ;2024-12-01;5;1;5;5;0;5;0;0;0;0;0;0;NTHMedia_S
R_1554_OK_1554OK                        ;2024-12-01;5;5;25;25;5;25;0;0;0;0;0;6;NTHMedia_S
R_2778_EROV2_2778Erov2                  ;2024-12-01;5;33;165;165;20;160;5;5;0;0;0;24;NTHMedia_S
R_2778_EROV3_2778Erov3                  ;2024-12-01;5;4;20;20;5;10;10;10;0;0;0;6;NTHMedia_S
R_5807_BMS_5807BMS                      ;2024-12-01;5;2;10;10;10;10;0;0;0;0;0;12;NTHMedia_S
S___1030HOT                             ;2024-12-01;150;241;36150;36150;4050;33450;2700;2700;0;0;0;4860;NTHMedia_S
S___1030LET                             ;2024-12-01;300;72;21600;21600;2400;21600;0;0;0;0;0;2880;NTHMedia_S
S___1030SPA                             ;2024-12-01;300;10;3000;3000;1200;3000;0;0;0;0;0;1440;NTHMedia_S
S___1123FT                              ;2024-12-01;150;27;4050;4050;0;4050;0;0;0;0;0;0;NTHMedia_S
S___1123FV                              ;2024-12-01;150;54;8100;8100;0;8100;0;0;0;0;0;0;NTHMedia_S
S___1123GA                              ;2024-12-01;150;9;1350;1350;1350;1350;0;0;0;0;0;1620;NTHMedia_S
S___1123HV                              ;2024-12-01;150;45;6750;6750;2700;6750;0;0;0;0;0;3240;NTHMedia_S
S___1123MV                              ;2024-12-01;150;192;28800;28800;2550;26100;2700;2700;0;0;0;3060;NTHMedia_S
S___1123MX                              ;2024-12-01;150;224;33600;33600;2700;33600;0;0;0;0;0;3240;NTHMedia_S
S___1518IGRA                            ;2024-12-01;150;9;1350;1350;0;1350;0;0;0;0;0;0;NTHMedia_S
S___1553GAMMA                           ;2024-12-01;300;584;175200;175200;39000;159900;15300;15300;0;0;0;46800;NTHMedia_S
S___1553Hd                              ;2024-12-01;150;83;12450;12450;0;11100;1350;1350;0;0;0;0;NTHMedia_S
S___1553OCISTI                          ;2024-12-01;300;157;47100;47100;3600;40500;6600;6600;0;0;0;4320;NTHMedia_S
S___1553VID                             ;2024-12-01;150;8;1200;1200;0;1200;0;0;0;0;0;0;NTHMedia_S
S___1553XONE                            ;2024-12-01;150;3275;491250;491250;92550;464250;27000;27000;0;0;0;111060;NTHMedia_S
S___1554AA                              ;2024-12-01;150;24;3600;3600;0;2400;1200;1200;0;0;0;0;NTHMedia_S
S___1554APC                             ;2024-12-01;300;14288;4286400;4286400;576900;4061100;225300;225300;0;0;0;692280;NTHMedia_S
S___1554EVG                             ;2024-12-01;150;898;134700;134700;25800;130650;4050;4050;0;0;0;30960;NTHMedia_S
S___1554FB                              ;2024-12-01;300;17;5100;5100;0;5100;0;0;0;0;0;0;NTHMedia_S
S___1554Gutanje                         ;2024-12-01;150;2;300;300;0;300;0;0;0;0;0;0;NTHMedia_S
S___1554Hit                             ;2024-12-01;150;4;600;600;0;600;0;0;0;0;0;0;NTHMedia_S
S___1554Horny                           ;2024-12-01;150;8;1200;1200;0;1200;0;0;0;0;0;0;NTHMedia_S
S___1554JPLAY                           ;2024-12-01;150;21;3150;3150;1650;3150;0;0;0;0;0;1980;NTHMedia_S
S___1554MOV                             ;2024-12-01;150;143;21450;21450;5400;20250;1200;1200;0;0;0;6480;NTHMedia_S
S___1554Puta                            ;2024-12-01;150;4;600;600;0;600;0;0;0;0;0;0;NTHMedia_S
S___1554RRR                             ;2024-12-01;150;652;97800;97800;7500;91950;5850;5850;0;0;0;9000;NTHMedia_S
S___1554Selfi                           ;2024-12-01;150;5;750;750;0;750;0;0;0;0;0;0;NTHMedia_S
S___1554Sise                            ;2024-12-01;150;10;1500;1500;750;1500;0;0;0;0;0;900;NTHMedia_S
S___1554Top                             ;2024-12-01;150;4;600;600;0;600;0;0;0;0;0;0;NTHMedia_S
S___1554TUBE                            ;2024-12-01;150;5425;813750;813750;142200;768600;45150;45150;0;0;0;170640;NTHMedia_S
S___1554UGZ                             ;2024-12-01;300;7;2100;2100;0;2100;0;0;0;0;0;0;NTHMedia_S
S___1554VID                             ;2024-12-01;300;17;5100;5100;0;5100;0;0;0;0;0;0;NTHMedia_S
S___1554Vruca                           ;2024-12-01;150;2;300;300;0;300;0;0;0;0;0;0;NTHMedia_S
S___1554XPORN                           ;2024-12-01;150;9;1350;1350;750;1350;0;0;0;0;0;900;NTHMedia_S
S___1556CRZ                             ;2024-12-01;150;39;5850;5850;1950;4500;1350;1350;0;0;0;2340;NTHMedia_S
S___1556PLAY                            ;2024-12-01;300;42;12600;12600;3000;11100;1500;1500;0;0;0;3600;NTHMedia_S
S___1556RAPID                           ;2024-12-01;150;3325;498750;498750;86550;468150;30600;30600;0;0;0;103860;NTHMedia_S
S___1556TOP                             ;2024-12-01;300;5;1500;1500;0;0;1500;1500;0;0;0;0;NTHMedia_S
S___1617NTHDomace                       ;2024-12-01;150;145;21750;21750;3450;19950;1800;1800;0;0;0;4140;NTHMedia_S
S___2229BusWapLand                      ;2024-12-01;80;4;320;320;0;320;0;0;0;0;0;0;NTHMedia_S
S___2229DnevniHoroskop                  ;2024-12-01;15;11;165;165;0;165;0;0;0;0;0;0;NTHMedia_S
S___2229TXTMania                        ;2024-12-01;15;848;12720;12720;855;12195;525;525;0;0;0;1026;NTHMedia_S
S___2229WapLandClub                     ;2024-12-01;90;137;12330;12330;810;12060;270;270;0;0;0;972;NTHMedia_S
S___2229WapLandClub18                   ;2024-12-01;50;4;200;200;0;200;0;0;0;0;0;0;NTHMedia_S
S___2229WapLandClub19                   ;2024-12-01;75;4;300;300;0;300;0;0;0;0;0;0;NTHMedia_S
S___2229WapLandKids11                   ;2024-12-01;90;74;6660;6660;990;6300;360;360;0;0;0;1188;NTHMedia_S
S___2229WapLandKids27                   ;2024-12-01;150;14;2100;2100;450;2100;0;0;0;0;0;540;NTHMedia_S
S___2232DESIRE                          ;2024-12-01;150;67;10050;10050;1950;9600;450;450;0;0;0;2340;NTHMedia_S
S___2232FTV                             ;2024-12-01;150;49;7350;7350;300;5700;1650;1650;0;0;0;360;NTHMedia_S
S___2345sedmica                         ;2024-12-01;35;5;175;175;175;175;0;0;0;0;0;210;NTHMedia_S
S___2778Erov2                           ;2024-12-01;300;42;12600;12600;2100;11700;900;900;0;0;0;2520;NTHMedia_S
S___2778Erov3                           ;2024-12-01;500;4;2000;2000;500;1000;1000;1000;0;0;0;600;NTHMedia_S
S___3334GEN                             ;2024-12-01;150;2549;382350;382350;81900;353700;28650;28650;0;0;0;98280;NTHMedia_S
S___4011BRAIN                           ;2024-12-01;150;3761;564150;564150;78300;524850;39300;39300;0;0;0;93960;NTHMedia_S
S___4011MEMO                            ;2024-12-01;150;9;1350;1350;0;1350;0;0;0;0;0;0;NTHMedia_S
S___4014HID                             ;2024-12-01;300;25;7500;7500;2400;7500;0;0;0;0;0;2880;NTHMedia_S
S___4016OCISTI                          ;2024-12-01;300;91;27300;27300;1200;19800;7500;7500;0;0;0;1440;NTHMedia_S
S___4025FB                              ;2024-12-01;150;295;44250;44250;6450;42750;1500;1500;0;0;0;7740;NTHMedia_S
S___4025TH                              ;2024-12-01;300;163;48900;48900;3600;48900;0;0;0;0;0;4320;NTHMedia_S
S___4091MS                              ;2024-12-01;300;9530;2859000;2859000;380700;2693700;165300;165300;0;0;0;456840;NTHMedia_S
S___4092ASTRO                           ;2024-12-01;300;97;29100;29100;4500;26400;2700;2700;0;0;0;5400;NTHMedia_S
S___4092GAMI                            ;2024-12-01;300;1797;539100;539100;80700;509100;30000;30000;0;0;0;96840;NTHMedia_S
S___4092M360                            ;2024-12-01;300;539;161700;161700;27900;145800;15900;15900;0;0;0;33480;NTHMedia_S
S___4093STREAM                          ;2024-12-01;150;2591;388650;388650;62850;372450;16200;16200;0;0;0;75420;NTHMedia_S
S___4094ABC                             ;2024-12-01;150;476;71400;71400;8850;70050;1350;1350;0;0;0;10620;NTHMedia_S
S___4094HUB                             ;2024-12-01;150;9143;1371450;1371450;198300;1305600;65850;65850;0;0;0;237960;NTHMedia_S
S___4272SM                              ;2024-12-01;300;9384;2815200;2815200;391800;2638200;177000;177000;0;0;0;470160;NTHMedia_S
S___4505AUGIE                           ;2024-12-01;300;728;218400;218400;29400;203400;15000;15000;0;0;0;35280;NTHMedia_S
S___4514AA                              ;2024-12-01;150;8;1200;1200;0;1200;0;0;0;0;0;0;NTHMedia_S
S___4514BA                              ;2024-12-01;300;5;1500;1500;0;1500;0;0;0;0;0;0;NTHMedia_S
S___4514CLUBEX                          ;2024-12-01;150;2;300;300;0;300;0;0;0;0;0;0;NTHMedia_S
S___4516ASTRO                           ;2024-12-01;150;74;11100;11100;1800;11100;0;0;0;0;0;2160;NTHMedia_S
S___4516CLEAN                           ;2024-12-01;150;29;4350;4350;0;4350;0;0;0;0;0;0;NTHMedia_S
S___4516DANCE                           ;2024-12-01;150;101;15150;15150;3900;13950;1200;1200;0;0;0;4680;NTHMedia_S
S___4516IQ                              ;2024-12-01;150;757;113550;113550;25800;105450;8100;8100;0;0;0;30960;NTHMedia_S
S___4516KLICK                           ;2024-12-01;150;486;72900;72900;13200;67350;5550;5550;0;0;0;15840;NTHMedia_S
S___4516LOL                             ;2024-12-01;150;62;9300;9300;0;6600;2700;2700;0;0;0;0;NTHMedia_S
S___4516LUNA                            ;2024-12-01;150;19;2850;2850;0;2850;0;0;0;0;0;0;NTHMedia_S
S___4516PIC                             ;2024-12-01;150;1617;242550;242550;40650;226350;16200;16200;0;0;0;48780;NTHMedia_S
S___4516SPICY                           ;2024-12-01;150;1860;279000;279000;56550;268050;10950;10950;0;0;0;67860;NTHMedia_S
S___4516WELL                            ;2024-12-01;150;140;21000;21000;4500;18000;3000;3000;0;0;0;5400;NTHMedia_S
S___4516WOW                             ;2024-12-01;150;118;17700;17700;2250;14550;3150;3150;0;0;0;2700;NTHMedia_S
S___4557HUB                             ;2024-12-01;150;293;43950;43950;7800;42000;1950;1950;0;0;0;9360;NTHMedia_S
S___4800FB                              ;2024-12-01;150;36;5400;5400;1350;5400;0;0;0;0;0;1620;NTHMedia_S
S___4800ON                              ;2024-12-01;150;4;600;600;0;600;0;0;0;0;0;0;NTHMedia_S
S___4820AW                              ;2024-12-01;150;720;108000;108000;16350;96450;11550;11550;0;0;0;19620;NTHMedia_S
S___4822KC                              ;2024-12-01;300;214;64200;64200;8100;58500;5700;5700;0;0;0;9720;NTHMedia_S
S___5060FC                              ;2024-12-01;300;3292;987600;987600;157200;933900;53700;53700;0;0;0;188640;NTHMedia_S
S___5200BED                             ;2024-12-01;300;100;30000;30000;3300;29700;300;300;0;0;0;3960;NTHMedia_S
S___5200GAM                             ;2024-12-01;150;2895;434250;434250;76650;398850;35400;35400;0;0;0;91980;NTHMedia_S
S___5225AP                              ;2024-12-01;150;120;18000;18000;4050;14550;3450;3450;0;0;0;4860;NTHMedia_S
S___5225FC                              ;2024-12-01;150;4627;694050;694050;104250;644700;49350;49350;0;0;0;125100;NTHMedia_S
S___5225GET                             ;2024-12-01;300;932;279600;279600;30900;248700;30900;30900;0;0;0;37080;NTHMedia_S
S___5444CF                              ;2024-12-01;300;939;281700;281700;51000;254100;27600;27600;0;0;0;61200;NTHMedia_S
S___5444PT                              ;2024-12-01;300;1051;315300;315300;48600;291000;24300;24300;0;0;0;58320;NTHMedia_S
S___5522WATCH                           ;2024-12-01;300;38;11400;11400;1200;9300;2100;2100;0;0;0;1440;NTHMedia_S
S___5530APPSFACTORY                     ;2024-12-01;150;351;52650;52650;9300;49950;2700;2700;0;0;0;11160;NTHMedia_S
S___5530FUN                             ;2024-12-01;150;18;2700;2700;0;2700;0;0;0;0;0;0;NTHMedia_S
S___5530GAMESBOX                        ;2024-12-01;150;23;3450;3450;0;3450;0;0;0;0;0;0;NTHMedia_S
S___5789CRZ                             ;2024-12-01;150;102;15300;15300;0;15300;0;0;0;0;0;0;NTHMedia_S
S___5791MMG                             ;2024-12-01;300;378;113400;113400;21900;98400;15000;15000;0;0;0;26280;NTHMedia_S
S___5791MMV                             ;2024-12-01;300;331;99300;99300;21600;87600;11700;11700;0;0;0;25920;NTHMedia_S
S___5791QCS                             ;2024-12-01;300;326;97800;97800;7200;87600;10200;10200;0;0;0;8640;NTHMedia_S
S___5791UGZ                             ;2024-12-01;300;423;126900;126900;15000;108000;18900;18900;0;0;0;18000;NTHMedia_S
S___5792PFL                             ;2024-12-01;300;146;43800;43800;12600;41400;2400;2400;0;0;0;15120;NTHMedia_S
S___5807BMS                             ;2024-12-01;150;2197;329550;329550;34950;311400;18150;18150;0;0;0;41940;NTHMedia_S
S___5807BT                              ;2024-12-01;150;3513;526950;526950;76650;512550;14400;14400;0;0;0;91980;NTHMedia_S
S___5807GYM                             ;2024-12-01;150;989;148350;148350;16050;142800;5550;5550;0;0;0;19260;NTHMedia_S
S___5807YC                              ;2024-12-01;150;5648;847200;847200;130350;809400;37800;37800;0;0;0;156420;NTHMedia_S
S___7008Sat                             ;2024-12-01;150;16;2400;2400;0;2400;0;0;0;0;0;0;NTHMedia_S
S___7008Sex                             ;2024-12-01;150;9;1350;1350;0;1350;0;0;0;0;0;0;NTHMedia_S
S___8807FIT                             ;2024-12-01;300;248;74400;74400;9000;69300;5100;5100;0;0;0;10800;NTHMedia_S
S___8807HORO                            ;2024-12-01;300;403;120900;120900;28800;111000;9900;9900;0;0;0;34560;NTHMedia_S
S___8807TK1                             ;2024-12-01;50;9;450;450;0;450;0;0;0;0;0;0;NTHMedia_S
S___8807TK10                            ;2024-12-01;50;9;450;450;0;450;0;0;0;0;0;0;NTHMedia_S
S___8807TK13                            ;2024-12-01;50;93;4650;4650;450;4650;0;0;0;0;0;540;NTHMedia_S
S___8807TK14                            ;2024-12-01;50;18;900;900;450;900;0;0;0;0;0;540;NTHMedia_S
S___8807TK2                             ;2024-12-01;50;37;1850;1850;0;900;950;950;0;0;0;0;NTHMedia_S
S___8809SKUEEDIO                        ;2024-12-01;300;972;291600;291600;38100;276900;14700;14700;0;0;0;45720;NTHMedia_S
S___GRAND                               ;2024-12-01;50;192;9600;9600;900;9350;250;250;0;0;0;1080;NTHMedia_S
S___NTHfun1666                          ;2024-12-01;300;42;12600;12600;0;11100;1500;1500;0;0;0;0;NTHMedia_S
S_1030_FUK_1030FUK                      ;2024-12-01;750;2;1500;1500;0;750;750;750;0;0;0;0;NTHMedia_S
S_1441__NthChat                         ;2024-12-01;150;1269;190350;190350;26850;156150;34200;34200;0;0;0;32220;NTHMedia_S
S_1553_BAL_1553BAL                      ;2024-12-01;150;24;3600;3600;150;1350;2250;2250;0;0;0;180;NTHMedia_S
S_1553_ISTINA_1553ISTINA                ;2024-12-01;150;4;600;600;300;600;0;0;0;0;0;360;NTHMedia_S
S_1553_KUL_KUL                          ;2024-12-01;100;2;200;200;0;200;0;0;0;0;0;0;NTHMedia_S
S_1553_KZV_1553KZV                      ;2024-12-01;300;1697;509100;509100;127800;487500;21600;21600;0;0;0;153360;NTHMedia_S
S_1553_SUDBINA_1553SUDBINA              ;2024-12-01;150;2;300;300;0;300;0;0;0;0;0;0;NTHMedia_S
S_1554_DAP_1554DAP                      ;2024-12-01;150;5;750;750;750;750;0;0;0;0;0;900;NTHMedia_S
S_1554_TKN_1554TKN                      ;2024-12-01;300;314;94200;94200;16500;91200;3000;3000;0;0;0;19800;NTHMedia_S
S_1554_VIA_1554VIA                      ;2024-12-01;600;727;436200;436200;37200;414600;21600;21600;0;0;0;44640;NTHMedia_S
S_1556_TAT1_1556TAT1                    ;2024-12-01;200;12;2400;2400;0;2200;200;200;0;0;0;0;NTHMedia_S
S_1556_TAT2_1556TAT2                    ;2024-12-01;300;266;79800;79800;22800;77700;2100;2100;0;0;0;27360;NTHMedia_S
S_1556_TLS1_1556TLS1                    ;2024-12-01;100;113;11300;11300;3100;11200;100;100;0;0;0;3720;NTHMedia_S
S_1556_TLS2_1556TLS2                    ;2024-12-01;150;9;1350;1350;150;1200;150;150;0;0;0;180;NTHMedia_S
S_1556_TLS3_1556TLS3                    ;2024-12-01;200;47;9400;9400;2000;9400;0;0;0;0;0;2400;NTHMedia_S
S_1556_TLS4_1556TLS4                    ;2024-12-01;300;91;27300;27300;4500;26100;1200;1200;0;0;0;5400;NTHMedia_S
S_1556_TLS5_1556TLS5                    ;2024-12-01;150;40;6000;6000;150;5850;150;150;0;0;0;180;NTHMedia_S
S_1556_TLS6_1556TLS6                    ;2024-12-01;300;8;2400;2400;0;2400;0;0;0;0;0;0;NTHMedia_S
S_1556_TLS8_1556TLS8                    ;2024-12-01;580;1;580;580;0;580;0;0;0;0;0;0;NTHMedia_S
S_1617_SEX_1617SEX                      ;2024-12-01;750;68;51000;51000;12000;48000;3000;3000;0;0;0;14400;NTHMedia_S
S_1617_TIK_1617TIK                      ;2024-12-01;750;5;3750;3750;0;2250;1500;1500;0;0;0;0;NTHMedia_S
S_1665_AN_1665An                        ;2024-12-01;300;2;600;600;0;600;0;0;0;0;0;0;NTHMedia_S
S_1665_SYM_1665SYM                      ;2024-12-01;450;20;9000;9000;3150;9000;0;0;0;0;0;3780;NTHMedia_S
S_1668_AKTIVIRAJ_1668AKTIVIRAJ          ;2024-12-01;1250;15;18750;18750;3750;16250;2500;2500;0;0;0;4500;NTHMedia_S
S_2778_ANDEO_2778ANDEO                  ;2024-12-01;450;153;68850;68850;13050;62550;6300;6300;0;0;0;15660;NTHMedia_S
S_2778_CODE_2778CODE                    ;2024-12-01;75;3;225;225;0;225;0;0;0;0;0;0;NTHMedia_S
S_2778_DAPA_2778DAPA                    ;2024-12-01;500;15;7500;7500;7500;7500;0;0;0;0;0;9000;NTHMedia_S
S_2778_GO_2778GO                        ;2024-12-01;180;32;5760;5760;0;3780;1980;1980;0;0;0;0;NTHMedia_S
S_2778_KEY_2778KEY                      ;2024-12-01;400;4;1600;1600;1200;1600;0;0;0;0;0;1440;NTHMedia_S
S_2778_LEN_2778LEN                      ;2024-12-01;450;108;48600;48600;5850;44100;4500;4500;0;0;0;7020;NTHMedia_S
S_2778_PIN_2778PIN                      ;2024-12-01;800;17;13600;13600;0;12000;1600;1600;0;0;0;0;NTHMedia_S
S_2778_REKVIZIT_2778REKVIZIT            ;2024-12-01;75;96;7200;7200;1350;7125;75;75;0;0;0;1620;NTHMedia_S
S_4023_MILICA_4023MILICA                ;2024-12-01;250;6;1500;1500;750;1500;0;0;0;0;0;900;NTHMedia_S
S_4023_PEDJA_4023PEDJA                  ;2024-12-01;250;1;250;250;0;250;0;0;0;0;0;0;NTHMedia_S
S_4023_SAVET_4023SAVET                  ;2024-12-01;250;5;1250;1250;0;1250;0;0;0;0;0;0;NTHMedia_S
S_4505_APEX_4505APEX                    ;2024-12-01;800;781;624800;624800;128000;595200;29600;29600;0;0;0;153600;NTHMedia_S
S_4640_PCA_4640PCA                      ;2024-12-01;5;94;470;470;25;450;20;20;0;0;0;30;NTHMedia_S
S_4640_UCA_4640UCA                      ;2024-12-01;5;6;30;30;0;30;0;0;0;0;0;0;NTHMedia_S
S_4644_100_4644100                      ;2024-12-01;100;38;3800;3800;100;3800;0;0;0;0;0;120;NTHMedia_S
S_4644_150_4644150                      ;2024-12-01;150;26;3900;3900;450;3900;0;0;0;0;0;540;NTHMedia_S
S_4644_200_4644200                      ;2024-12-01;200;31;6200;6200;0;6200;0;0;0;0;0;0;NTHMedia_S
S_4644_25_464425                        ;2024-12-01;25;1;25;25;0;25;0;0;0;0;0;0;NTHMedia_S
S_4644_300_4644300                      ;2024-12-01;300;44;13200;13200;3600;12900;300;300;0;0;0;4320;NTHMedia_S
S_4644_50_464450                        ;2024-12-01;50;19;950;950;150;900;50;50;0;0;0;180;NTHMedia_S
S_4644_GAME_4644GAME                    ;2024-12-01;50;5;250;250;0;250;0;0;0;0;0;0;NTHMedia_S
S_4644_GAME1_4644GAME1                  ;2024-12-01;100;1;100;100;100;100;0;0;0;0;0;120;NTHMedia_S
S_4644_GAME2_4644GAME2                  ;2024-12-01;150;433;64950;64950;5100;61500;3450;3450;0;0;0;6120;NTHMedia_S
S_4644_GAME3_4644GAME3                  ;2024-12-01;200;1;200;200;0;200;0;0;0;0;0;0;NTHMedia_S
S_4644_GAME4_4644GAME4                  ;2024-12-01;300;2;600;600;0;600;0;0;0;0;0;0;NTHMedia_S
S_4644_MAT_4644MAT                      ;2024-12-01;580;72;41760;41760;12760;41760;0;0;0;0;0;15312;NTHMedia_S
S_4644_TXT_4644TXT                      ;2024-12-01;800;34;27200;27200;7200;25600;1600;1600;0;0;0;8640;NTHMedia_S
S_5232_SLA_5232SLA                      ;2024-12-01;150;1026;153900;153900;31950;145500;8400;8400;0;0;0;38340;NTHMedia_S
S_5232_SLA1_5232SLA1                    ;2024-12-01;200;490;98000;98000;8400;94400;3600;3600;0;0;0;10080;NTHMedia_S
S_5232_SLA2_5232SLA2                    ;2024-12-01;300;279;83700;83700;12600;74700;9000;9000;0;0;0;15120;NTHMedia_S
S_5232_SLA3_5232SLA3                    ;2024-12-01;580;88;51040;51040;9280;48140;2900;2900;0;0;0;11136;NTHMedia_S
S_5232_SLA4_5232SLA4                    ;2024-12-01;800;29;23200;23200;5600;22400;800;800;0;0;0;6720;NTHMedia_S
S_5332_RATE_5332SmsRateUnicredit        ;2024-12-01;6;4024;24144;24144;3966;23382;762;762;0;0;0;4759.2;NTHMedia_S
S_5332_STA_5332UnicreditUpitStanja      ;2024-12-01;6;1400;8400;8400;1110;8208;192;192;0;0;0;1332;NTHMedia_S
S_7008_TAROT247_NTHTarot247             ;2024-12-01;50;38;1900;1900;0;1900;0;0;0;0;0;0;NTHMedia_S
O_1030_STOPHOT_1030HOT                  ;2025-01-01;5;3;15;15;10;10;5;5;0;0;0;12;NTHMedia_S
O_1030_STOPLET_1030LET                  ;2025-01-01;5;1;5;5;5;5;0;0;0;0;0;6;NTHMedia_S
O_1123_STOPMV_1123MV                    ;2025-01-01;5;2;10;10;5;5;5;5;0;0;0;6;NTHMedia_S
O_1518_STOPIGRA_1518IGRA                ;2025-01-01;5;1;5;5;5;5;0;0;0;0;0;6;NTHMedia_S
O_1553_STOPGAMERS_1553GAMERS            ;2025-01-01;5;1;5;5;5;5;0;0;0;0;0;6;NTHMedia_S
O_1553_STOPGAMMA_1553GAMMA              ;2025-01-01;5;36;180;180;125;125;55;55;0;0;0;150;NTHMedia_S
O_1553_STOPMEV_1553Mev                  ;2025-01-01;5;4;20;20;20;20;0;0;0;0;0;24;NTHMedia_S
O_1553_STOPMOGA_1553MOGA                ;2025-01-01;5;1;5;5;5;5;0;0;0;0;0;6;NTHMedia_S
O_1553_STOPOCISTI_1553OCISTI            ;2025-01-01;5;6;30;30;30;30;0;0;0;0;0;36;NTHMedia_S
O_1553_STOPTOP_1553Top                  ;2025-01-01;5;2;10;10;5;5;5;5;0;0;0;6;NTHMedia_S
O_1553_STOPXONE_1553XONE                ;2025-01-01;5;98;490;490;395;395;95;95;0;0;0;474;NTHMedia_S
O_1554_STOPAA_1554AA                    ;2025-01-01;5;1;5;5;5;5;0;0;0;0;0;6;NTHMedia_S
O_1554_STOPAPC_1554APC                  ;2025-01-01;5;1813;9065;9065;7525;7525;1540;1540;0;0;0;9030;NTHMedia_S
O_1554_STOPBVV_1554BVV                  ;2025-01-01;5;2;10;10;10;10;0;0;0;0;0;12;NTHMedia_S
O_1554_STOPEVG_1554EVG                  ;2025-01-01;5;136;680;680;550;550;130;130;0;0;0;660;NTHMedia_S
O_1554_STOPMOV_1554MOV                  ;2025-01-01;5;3;15;15;10;10;5;5;0;0;0;12;NTHMedia_S
O_1554_STOPOK_1554OK                    ;2025-01-01;5;2;10;10;10;10;0;0;0;0;0;12;NTHMedia_S
O_1554_STOPRRR_1554RRR                  ;2025-01-01;5;3;15;15;15;15;0;0;0;0;0;18;NTHMedia_S
O_1554_STOPTUBE_1554TUBE                ;2025-01-01;5;387;1935;1935;1490;1490;445;445;0;0;0;1788;NTHMedia_S
O_1554_STOPUGZ_1554UGZ                  ;2025-01-01;5;1;5;5;5;5;0;0;0;0;0;6;NTHMedia_S
O_1556_STOPGAMI_1556GAMI                ;2025-01-01;5;4;20;20;20;20;0;0;0;0;0;24;NTHMedia_S
O_1556_STOPPLAY_1556PLAY                ;2025-01-01;5;1;5;5;0;0;5;5;0;0;0;0;NTHMedia_S
O_1556_STOPRAPID_1556RAPID              ;2025-01-01;5;55;275;275;200;200;75;75;0;0;0;240;NTHMedia_S
O_1556_STOPTOP_1556TOP                  ;2025-01-01;5;2;10;10;10;10;0;0;0;0;0;12;NTHMedia_S
O_1617_STOPDOMACE_1617NTHDomace         ;2025-01-01;5;2;10;10;10;10;0;0;0;0;0;12;NTHMedia_S
O_1666_STOPFUN_NTHfun1666               ;2025-01-01;5;2;10;10;5;5;5;5;0;0;0;6;NTHMedia_S
O_2345_STOPZABAVA_2345zabava            ;2025-01-01;5;1;5;5;5;5;0;0;0;0;0;6;NTHMedia_S
O_2778_STOPEROV2_2778Erov2              ;2025-01-01;5;20;100;100;80;80;20;20;0;0;0;96;NTHMedia_S
O_2778_STOPEROV3_2778Erov3              ;2025-01-01;5;6;30;30;20;20;10;10;0;0;0;24;NTHMedia_S
O_3334_STOPGEN_3334GEN                  ;2025-01-01;5;370;1850;1850;1370;1370;480;480;0;0;0;1644;NTHMedia_S
O_4010_STOPMOB_4010MOB                  ;2025-01-01;5;2;10;10;5;5;5;5;0;0;0;6;NTHMedia_S
O_4011_STOPBRAIN_4011BRAIN              ;2025-01-01;5;248;1240;1240;955;955;285;285;0;0;0;1146;NTHMedia_S
O_4014_STOPHID_4014HID                  ;2025-01-01;5;3;15;15;15;15;0;0;0;0;0;18;NTHMedia_S
O_4016_STOPOCISTI_4016OCISTI            ;2025-01-01;5;1;5;5;5;5;0;0;0;0;0;6;NTHMedia_S
O_4025_STOPFB_4025FB                    ;2025-01-01;5;1;5;5;5;5;0;0;0;0;0;6;NTHMedia_S
O_4025_STOPTH_4025TH                    ;2025-01-01;5;5;25;25;20;20;5;5;0;0;0;24;NTHMedia_S
O_4091_STOPMS_4091MS                    ;2025-01-01;5;1104;5520;5520;4585;4585;935;935;0;0;0;5502;NTHMedia_S
O_4092_STOPASTRO_4092ASTRO              ;2025-01-01;5;1;5;5;5;5;0;0;0;0;0;6;NTHMedia_S
O_4092_STOPGAMI_4092GAMI                ;2025-01-01;5;281;1405;1405;1105;1105;300;300;0;0;0;1326;NTHMedia_S
O_4092_STOPM360_4092M360                ;2025-01-01;5;12;60;60;55;55;5;5;0;0;0;66;NTHMedia_S
O_4093_STOPSTREAM_4093STREAM            ;2025-01-01;5;1131;5655;5655;4550;4550;1105;1105;0;0;0;5460;NTHMedia_S
O_4094_STOPABC_4094ABC                  ;2025-01-01;5;10;50;50;40;40;10;10;0;0;0;48;NTHMedia_S
O_4094_STOPHUB_4094HUB                  ;2025-01-01;5;271;1355;1355;1065;1065;290;290;0;0;0;1278;NTHMedia_S
O_4094_STOPIGRAJ_4094IGRAJ              ;2025-01-01;5;2;10;10;10;10;0;0;0;0;0;12;NTHMedia_S
O_4097_STOPAAA_4097AAA                  ;2025-01-01;5;1;5;5;5;5;0;0;0;0;0;6;NTHMedia_S
O_4098_STOPAAA_4098AAA                  ;2025-01-01;5;4;20;20;10;10;10;10;0;0;0;12;NTHMedia_S
O_4272_STOPSM_4272SM                    ;2025-01-01;5;924;4620;4620;3770;3770;850;850;0;0;0;4524;NTHMedia_S
O_4466_STOPASF_NthAsf                   ;2025-01-01;5;1;5;5;5;5;0;0;0;0;0;6;NTHMedia_S
O_4505_STOPAUGIE_4505AUGIE              ;2025-01-01;5;315;1575;1575;1290;1290;285;285;0;0;0;1548;NTHMedia_S
O_4516_STOPDANCE_4516DANCE              ;2025-01-01;5;1;5;5;5;5;0;0;0;0;0;6;NTHMedia_S
O_4516_STOPFUN_4516FUN                  ;2025-01-01;5;4;20;20;10;10;10;10;0;0;0;12;NTHMedia_S
O_4516_STOPIQ_4516IQ                    ;2025-01-01;5;3;15;15;15;15;0;0;0;0;0;18;NTHMedia_S
O_4516_STOPKLICK_4516KLICK              ;2025-01-01;5;4;20;20;15;15;5;5;0;0;0;18;NTHMedia_S
O_4516_STOPLOL_4516LOL                  ;2025-01-01;5;1;5;5;5;5;0;0;0;0;0;6;NTHMedia_S
O_4516_STOPPIC_4516PIC                  ;2025-01-01;5;41;205;205;170;170;35;35;0;0;0;204;NTHMedia_S
O_4516_STOPSPICY_4516SPICY              ;2025-01-01;5;23;115;115;95;95;20;20;0;0;0;114;NTHMedia_S
O_4516_STOPWOW_4516WOW                  ;2025-01-01;5;2;10;10;10;10;0;0;0;0;0;12;NTHMedia_S
O_4557_STOPHUB_4557HUB                  ;2025-01-01;5;1;5;5;5;5;0;0;0;0;0;6;NTHMedia_S
O_4820_STOPAW_4820AW                    ;2025-01-01;5;90;450;450;355;355;95;95;0;0;0;426;NTHMedia_S
O_4822_STOPKC_4822KC                    ;2025-01-01;5;36;180;180;140;140;40;40;0;0;0;168;NTHMedia_S
O_5060_STOPFC_5060FC                    ;2025-01-01;5;298;1490;1490;1190;1190;300;300;0;0;0;1428;NTHMedia_S
O_5060_STOPOK_5060OK                    ;2025-01-01;5;1;5;5;5;5;0;0;0;0;0;6;NTHMedia_S
O_5200_STOPBED_5200BED                  ;2025-01-01;5;15;75;75;65;65;10;10;0;0;0;78;NTHMedia_S
O_5200_STOPGAM_5200GAM                  ;2025-01-01;5;139;695;695;505;505;190;190;0;0;0;606;NTHMedia_S
O_5225_STOPAP_5225AP                    ;2025-01-01;5;2;10;10;10;10;0;0;0;0;0;12;NTHMedia_S
O_5225_STOPFC_5225FC                    ;2025-01-01;5;22;110;110;95;95;15;15;0;0;0;114;NTHMedia_S
O_5225_STOPGET_5225GET                  ;2025-01-01;5;8;40;40;30;30;10;10;0;0;0;36;NTHMedia_S
O_5444_STOPCF_5444CF                    ;2025-01-01;5;7;35;35;25;25;10;10;0;0;0;30;NTHMedia_S
O_5444_STOPPT_5444PT                    ;2025-01-01;5;12;60;60;45;45;15;15;0;0;0;54;NTHMedia_S
O_5522_STOPWATCH_5522WATCH              ;2025-01-01;5;22;110;110;95;95;15;15;0;0;0;114;NTHMedia_S
O_5530_STOPAPPSFACTORY_5530APPSFACTORY  ;2025-01-01;5;37;185;185;115;115;70;70;0;0;0;138;NTHMedia_S
O_5530_STOPFUN_5530FUN                  ;2025-01-01;5;1;5;5;5;5;0;0;0;0;0;6;NTHMedia_S
O_5789_STOPCRZ_5789CRZ                  ;2025-01-01;5;2;10;10;0;0;10;10;0;0;0;0;NTHMedia_S
O_5791_STOPMMG_5791MMG                  ;2025-01-01;5;4;20;20;20;20;0;0;0;0;0;24;NTHMedia_S
O_5791_STOPMMV_5791MMV                  ;2025-01-01;5;4;20;20;10;10;10;10;0;0;0;12;NTHMedia_S
O_5791_STOPQCS_5791QCS                  ;2025-01-01;5;2;10;10;5;5;5;5;0;0;0;6;NTHMedia_S
O_5791_STOPUGZ_5791UGZ                  ;2025-01-01;5;5;25;25;15;15;10;10;0;0;0;18;NTHMedia_S
O_5792_STOPPFL_5792PFL                  ;2025-01-01;5;51;255;255;210;210;45;45;0;0;0;252;NTHMedia_S
O_5807_STOPBMS_5807BMS                  ;2025-01-01;5;137;685;685;575;575;110;110;0;0;0;690;NTHMedia_S
O_5807_STOPBT_5807BT                    ;2025-01-01;5;105;525;525;435;435;90;90;0;0;0;522;NTHMedia_S
O_5807_STOPGYM_5807GYM                  ;2025-01-01;5;72;360;360;310;310;50;50;0;0;0;372;NTHMedia_S
O_5807_STOPYC_5807YC                    ;2025-01-01;5;87;435;435;335;335;100;100;0;0;0;402;NTHMedia_S
O_6336_STOPWO_6336WO                    ;2025-01-01;5;3;15;15;15;15;0;0;0;0;0;18;NTHMedia_S
O_8807_STOPFIT_8807FIT                  ;2025-01-01;5;53;265;265;210;210;55;55;0;0;0;252;NTHMedia_S
O_8807_STOPHORO_8807HORO                ;2025-01-01;5;65;325;325;265;265;60;60;0;0;0;318;NTHMedia_S
O_8809_STOPSKUEEDIO_8809SKUEEDIO        ;2025-01-01;5;261;1305;1305;1110;1110;195;195;0;0;0;1332;NTHMedia_S
R_1030_HOT_1030HOT                      ;2025-01-01;5;1;5;5;5;5;0;0;0;0;0;6;NTHMedia_S
R_1554_GIRLS_1554GIRLS                  ;2025-01-01;5;1;5;5;5;5;0;0;0;0;0;6;NTHMedia_S
R_1554_MOV_1554MOV                      ;2025-01-01;5;1;5;5;5;5;0;0;0;0;0;6;NTHMedia_S
R_1554_OK_1554OK                        ;2025-01-01;5;2;10;10;10;10;0;0;0;0;0;12;NTHMedia_S
R_2778_EROV2_2778Erov2                  ;2025-01-01;5;25;125;125;90;90;35;35;0;0;0;108;NTHMedia_S
R_2778_EROV3_2778Erov3                  ;2025-01-01;5;6;30;30;20;20;10;10;0;0;0;24;NTHMedia_S
R_5792_PFL_5792PFL                      ;2025-01-01;5;1;5;5;5;5;0;0;0;0;0;6;NTHMedia_S
R_8809_SKUEEDIO_8809SKUEEDIO            ;2025-01-01;5;1;5;5;5;5;0;0;0;0;0;6;NTHMedia_S
S___1030HOT                             ;2025-01-01;150;243;36450;36450;29850;29850;6600;6600;0;0;0;35820;NTHMedia_S
S___1030LET                             ;2025-01-01;300;84;25200;25200;20700;20700;4500;4500;0;0;0;24840;NTHMedia_S
S___1030SPA                             ;2025-01-01;300;12;3600;3600;2100;2100;1500;1500;0;0;0;2520;NTHMedia_S
S___1123FT                              ;2025-01-01;150;26;3900;3900;3900;3900;0;0;0;0;0;4680;NTHMedia_S
S___1123FV                              ;2025-01-01;150;54;8100;8100;8100;8100;0;0;0;0;0;9720;NTHMedia_S
S___1123GA                              ;2025-01-01;150;8;1200;1200;0;0;1200;1200;0;0;0;0;NTHMedia_S
S___1123HV                              ;2025-01-01;150;42;6300;6300;3750;3750;2550;2550;0;0;0;4500;NTHMedia_S
S___1123MV                              ;2025-01-01;150;183;27450;27450;22350;22350;5100;5100;0;0;0;26820;NTHMedia_S
S___1123MX                              ;2025-01-01;150;218;32700;32700;28650;28650;4050;4050;0;0;0;34380;NTHMedia_S
S___1518IGRA                            ;2025-01-01;150;9;1350;1350;1350;1350;0;0;0;0;0;1620;NTHMedia_S
S___1553GAMMA                           ;2025-01-01;300;610;183000;183000;118800;118800;64200;64200;0;0;0;142560;NTHMedia_S
S___1553Hd                              ;2025-01-01;150;82;12300;12300;9600;9600;2700;2700;0;0;0;11520;NTHMedia_S
S___1553OCISTI                          ;2025-01-01;300;152;45600;45600;35400;35400;10200;10200;0;0;0;42480;NTHMedia_S
S___1553VID                             ;2025-01-01;150;11;1650;1650;1650;1650;0;0;0;0;0;1980;NTHMedia_S
S___1553XONE                            ;2025-01-01;150;3086;462900;462900;345900;345900;117000;117000;0;0;0;415080;NTHMedia_S
S___1554AA                              ;2025-01-01;150;30;4500;4500;3000;3000;1500;1500;0;0;0;3600;NTHMedia_S
S___1554APC                             ;2025-01-01;300;16310;4893000;4893000;3817200;3817200;1075800;1075800;0;0;0;4580640;NTHMedia_S
S___1554EVG                             ;2025-01-01;150;1421;213150;213150;154950;154950;58200;58200;0;0;0;185940;NTHMedia_S
S___1554FB                              ;2025-01-01;300;17;5100;5100;2700;2700;2400;2400;0;0;0;3240;NTHMedia_S
S___1554Gutanje                         ;2025-01-01;150;4;600;600;600;600;0;0;0;0;0;720;NTHMedia_S
S___1554Hit                             ;2025-01-01;150;4;600;600;600;600;0;0;0;0;0;720;NTHMedia_S
S___1554Horny                           ;2025-01-01;150;9;1350;1350;1350;1350;0;0;0;0;0;1620;NTHMedia_S
S___1554JPLAY                           ;2025-01-01;150;15;2250;2250;2250;2250;0;0;0;0;0;2700;NTHMedia_S
S___1554MOV                             ;2025-01-01;150;138;20700;20700;13800;13800;6900;6900;0;0;0;16560;NTHMedia_S
S___1554Puta                            ;2025-01-01;150;4;600;600;600;600;0;0;0;0;0;720;NTHMedia_S
S___1554RRR                             ;2025-01-01;150;645;96750;96750;83850;83850;12900;12900;0;0;0;100620;NTHMedia_S
S___1554Selfi                           ;2025-01-01;150;4;600;600;600;600;0;0;0;0;0;720;NTHMedia_S
S___1554Sise                            ;2025-01-01;150;8;1200;1200;600;600;600;600;0;0;0;720;NTHMedia_S
S___1554Top                             ;2025-01-01;150;5;750;750;750;750;0;0;0;0;0;900;NTHMedia_S
S___1554TUBE                            ;2025-01-01;150;6191;928650;928650;665100;665100;263550;263550;0;0;0;798120;NTHMedia_S
S___1554UGZ                             ;2025-01-01;300;9;2700;2700;2700;2700;0;0;0;0;0;3240;NTHMedia_S
S___1554VID                             ;2025-01-01;300;18;5400;5400;4200;4200;1200;1200;0;0;0;5040;NTHMedia_S
S___1554Vruca                           ;2025-01-01;150;2;300;300;300;300;0;0;0;0;0;360;NTHMedia_S
S___1554XPORN                           ;2025-01-01;150;8;1200;1200;1200;1200;0;0;0;0;0;1440;NTHMedia_S
S___1556CRZ                             ;2025-01-01;150;42;6300;6300;2700;2700;3600;3600;0;0;0;3240;NTHMedia_S
S___1556PLAY                            ;2025-01-01;300;35;10500;10500;8100;8100;2400;2400;0;0;0;9720;NTHMedia_S
S___1556RAPID                           ;2025-01-01;150;2497;374550;374550;260400;260400;114150;114150;0;0;0;312480;NTHMedia_S
S___1556TOP                             ;2025-01-01;300;4;1200;1200;0;0;1200;1200;0;0;0;0;NTHMedia_S
S___1617NTHDomace                       ;2025-01-01;150;178;26700;26700;19350;19350;7350;7350;0;0;0;23220;NTHMedia_S
S___2229BusWapLand                      ;2025-01-01;80;5;400;400;400;400;0;0;0;0;0;480;NTHMedia_S
S___2229DnevniHoroskop                  ;2025-01-01;15;22;330;330;330;330;0;0;0;0;0;396;NTHMedia_S
S___2229TXTMania                        ;2025-01-01;15;890;13350;13350;11370;11370;1980;1980;0;0;0;13644;NTHMedia_S
S___2229WapLandClub                     ;2025-01-01;90;169;15210;15210;12780;12780;2430;2430;0;0;0;15336;NTHMedia_S
S___2229WapLandClub18                   ;2025-01-01;50;5;250;250;250;250;0;0;0;0;0;300;NTHMedia_S
S___2229WapLandClub19                   ;2025-01-01;75;5;375;375;375;375;0;0;0;0;0;450;NTHMedia_S
S___2229WapLandKids11                   ;2025-01-01;90;84;7560;7560;4950;4950;2610;2610;0;0;0;5940;NTHMedia_S
S___2229WapLandKids27                   ;2025-01-01;150;19;2850;2850;2850;2850;0;0;0;0;0;3420;NTHMedia_S
S___2232DESIRE                          ;2025-01-01;150;342;51300;51300;42750;42750;8550;8550;0;0;0;51300;NTHMedia_S
S___2232FTV                             ;2025-01-01;150;96;14400;14400;11250;11250;3150;3150;0;0;0;13500;NTHMedia_S
S___2345sedmica                         ;2025-01-01;35;4;140;140;0;0;140;140;0;0;0;0;NTHMedia_S
S___2778Erov2                           ;2025-01-01;300;34;10200;10200;5700;5700;4500;4500;0;0;0;6840;NTHMedia_S
S___2778Erov3                           ;2025-01-01;500;5;2500;2500;2000;2000;500;500;0;0;0;2400;NTHMedia_S
S___3334GEN                             ;2025-01-01;150;3907;586050;586050;403950;403950;182100;182100;0;0;0;484740;NTHMedia_S
S___4011BRAIN                           ;2025-01-01;150;4854;728100;728100;541500;541500;186600;186600;0;0;0;649800;NTHMedia_S
S___4011MEMO                            ;2025-01-01;150;9;1350;1350;0;0;1350;1350;0;0;0;0;NTHMedia_S
S___4014HID                             ;2025-01-01;300;32;9600;9600;6600;6600;3000;3000;0;0;0;7920;NTHMedia_S
S___4016OCISTI                          ;2025-01-01;300;78;23400;23400;14700;14700;8700;8700;0;0;0;17640;NTHMedia_S
S___4025FB                              ;2025-01-01;150;277;41550;41550;32100;32100;9450;9450;0;0;0;38520;NTHMedia_S
S___4025TH                              ;2025-01-01;300;113;33900;33900;29400;29400;4500;4500;0;0;0;35280;NTHMedia_S
S___4091MS                              ;2025-01-01;300;12054;3616200;3616200;2804700;2804700;811500;811500;0;0;0;3365640;NTHMedia_S
S___4092ASTRO                           ;2025-01-01;300;93;27900;27900;21000;21000;6900;6900;0;0;0;25200;NTHMedia_S
S___4092GAMI                            ;2025-01-01;300;1741;522300;522300;394500;394500;127800;127800;0;0;0;473400;NTHMedia_S
S___4092M360                            ;2025-01-01;300;504;151200;151200;110400;110400;40800;40800;0;0;0;132480;NTHMedia_S
S___4093STREAM                          ;2025-01-01;150;6178;926700;926700;713700;713700;213000;213000;0;0;0;856440;NTHMedia_S
S___4094ABC                             ;2025-01-01;150;447;67050;67050;52200;52200;14850;14850;0;0;0;62640;NTHMedia_S
S___4094HUB                             ;2025-01-01;150;7548;1132200;1132200;850500;850500;281700;281700;0;0;0;1020600;NTHMedia_S
S___4272SM                              ;2025-01-01;300;8804;2641200;2641200;2033100;2033100;608100;608100;0;0;0;2439720;NTHMedia_S
S___4505AUGIE                           ;2025-01-01;300;1815;544500;544500;417900;417900;126600;126600;0;0;0;501480;NTHMedia_S
S___4514AA                              ;2025-01-01;150;10;1500;1500;1500;1500;0;0;0;0;0;1800;NTHMedia_S
S___4514BA                              ;2025-01-01;300;4;1200;1200;1200;1200;0;0;0;0;0;1440;NTHMedia_S
S___4516ASTRO                           ;2025-01-01;150;81;12150;12150;9000;9000;3150;3150;0;0;0;10800;NTHMedia_S
S___4516CLEAN                           ;2025-01-01;150;31;4650;4650;4650;4650;0;0;0;0;0;5580;NTHMedia_S
S___4516DANCE                           ;2025-01-01;150;97;14550;14550;8850;8850;5700;5700;0;0;0;10620;NTHMedia_S
S___4516IQ                              ;2025-01-01;150;747;112050;112050;80250;80250;31800;31800;0;0;0;96300;NTHMedia_S
S___4516KLICK                           ;2025-01-01;150;464;69600;69600;52050;52050;17550;17550;0;0;0;62460;NTHMedia_S
S___4516LOL                             ;2025-01-01;150;56;8400;8400;5400;5400;3000;3000;0;0;0;6480;NTHMedia_S
S___4516LUNA                            ;2025-01-01;150;22;3300;3300;3300;3300;0;0;0;0;0;3960;NTHMedia_S
S___4516PIC                             ;2025-01-01;150;1219;182850;182850;133800;133800;49050;49050;0;0;0;160560;NTHMedia_S
S___4516SPICY                           ;2025-01-01;150;1715;257250;257250;193950;193950;63300;63300;0;0;0;232740;NTHMedia_S
S___4516WELL                            ;2025-01-01;150;150;22500;22500;11700;11700;10800;10800;0;0;0;14040;NTHMedia_S
S___4516WOW                             ;2025-01-01;150;110;16500;16500;12900;12900;3600;3600;0;0;0;15480;NTHMedia_S
S___4557HUB                             ;2025-01-01;150;280;42000;42000;35400;35400;6600;6600;0;0;0;42480;NTHMedia_S
S___4800FB                              ;2025-01-01;150;36;5400;5400;4050;4050;1350;1350;0;0;0;4860;NTHMedia_S
S___4800ON                              ;2025-01-01;150;5;750;750;750;750;0;0;0;0;0;900;NTHMedia_S
S___4820AW                              ;2025-01-01;150;1054;158100;158100;124050;124050;34050;34050;0;0;0;148860;NTHMedia_S
S___4822KC                              ;2025-01-01;300;330;99000;99000;71700;71700;27300;27300;0;0;0;86040;NTHMedia_S
S___5060FC                              ;2025-01-01;300;2434;730200;730200;550500;550500;179700;179700;0;0;0;660600;NTHMedia_S
S___5200BED                             ;2025-01-01;300;83;24900;24900;16800;16800;8100;8100;0;0;0;20160;NTHMedia_S
S___5200GAM                             ;2025-01-01;150;2912;436800;436800;312300;312300;124500;124500;0;0;0;374760;NTHMedia_S
S___5225AP                              ;2025-01-01;150;121;18150;18150;10500;10500;7650;7650;0;0;0;12600;NTHMedia_S
S___5225FC                              ;2025-01-01;150;4430;664500;664500;508950;508950;155550;155550;0;0;0;610740;NTHMedia_S
S___5225GET                             ;2025-01-01;300;860;258000;258000;190200;190200;67800;67800;0;0;0;228240;NTHMedia_S
S___5444CF                              ;2025-01-01;300;867;260100;260100;189900;189900;70200;70200;0;0;0;227880;NTHMedia_S
S___5444PT                              ;2025-01-01;300;931;279300;279300;213000;213000;66300;66300;0;0;0;255600;NTHMedia_S
S___5522WATCH                           ;2025-01-01;300;92;27600;27600;19800;19800;7800;7800;0;0;0;23760;NTHMedia_S
S___5530APPSFACTORY                     ;2025-01-01;150;452;67800;67800;52500;52500;15300;15300;0;0;0;63000;NTHMedia_S
S___5530FUN                             ;2025-01-01;150;16;2400;2400;2400;2400;0;0;0;0;0;2880;NTHMedia_S
S___5530GAMESBOX                        ;2025-01-01;150;22;3300;3300;3300;3300;0;0;0;0;0;3960;NTHMedia_S
S___5789CRZ                             ;2025-01-01;150;96;14400;14400;12900;12900;1500;1500;0;0;0;15480;NTHMedia_S
S___5791MMG                             ;2025-01-01;300;349;104700;104700;74700;74700;30000;30000;0;0;0;89640;NTHMedia_S
S___5791MMV                             ;2025-01-01;300;281;84300;84300;59100;59100;25200;25200;0;0;0;70920;NTHMedia_S
S___5791QCS                             ;2025-01-01;300;294;88200;88200;66300;66300;21900;21900;0;0;0;79560;NTHMedia_S
S___5791UGZ                             ;2025-01-01;300;369;110700;110700;85800;85800;24900;24900;0;0;0;102960;NTHMedia_S
S___5792PFL                             ;2025-01-01;300;330;99000;99000;65400;65400;33600;33600;0;0;0;78480;NTHMedia_S
S___5807BMS                             ;2025-01-01;150;2100;315000;315000;252000;252000;63000;63000;0;0;0;302400;NTHMedia_S
S___5807BT                              ;2025-01-01;150;2610;391500;391500;305400;305400;86100;86100;0;0;0;366480;NTHMedia_S
S___5807GYM                             ;2025-01-01;150;776;116400;116400;100950;100950;15450;15450;0;0;0;121140;NTHMedia_S
S___5807YC                              ;2025-01-01;150;4209;631350;631350;479850;479850;151500;151500;0;0;0;575820;NTHMedia_S
S___6336WO                              ;2025-01-01;300;5;1500;1500;1500;1500;0;0;0;0;0;1800;NTHMedia_S
S___7008Sat                             ;2025-01-01;150;20;3000;3000;2250;2250;750;750;0;0;0;2700;NTHMedia_S
S___7008Sex                             ;2025-01-01;150;9;1350;1350;1350;1350;0;0;0;0;0;1620;NTHMedia_S
S___8807FIT                             ;2025-01-01;300;319;95700;95700;68700;68700;27000;27000;0;0;0;82440;NTHMedia_S
S___8807HORO                            ;2025-01-01;300;628;188400;188400;132600;132600;55800;55800;0;0;0;159120;NTHMedia_S
S___8807TK1                             ;2025-01-01;50;9;450;450;450;450;0;0;0;0;0;540;NTHMedia_S
S___8807TK10                            ;2025-01-01;50;9;450;450;450;450;0;0;0;0;0;540;NTHMedia_S
S___8807TK13                            ;2025-01-01;50;87;4350;4350;3700;3700;650;650;0;0;0;4440;NTHMedia_S
S___8807TK14                            ;2025-01-01;50;18;900;900;900;900;0;0;0;0;0;1080;NTHMedia_S
S___8807TK2                             ;2025-01-01;50;37;1850;1850;900;900;950;950;0;0;0;1080;NTHMedia_S
S___8809SKUEEDIO                        ;2025-01-01;300;1540;462000;462000;353700;353700;108300;108300;0;0;0;424440;NTHMedia_S
S___GRAND                               ;2025-01-01;50;173;8650;8650;7000;7000;1650;1650;0;0;0;8400;NTHMedia_S
S___NTHfun1666                          ;2025-01-01;300;38;11400;11400;10200;10200;1200;1200;0;0;0;12240;NTHMedia_S
S_1030_FUK_1030FUK                      ;2025-01-01;750;1;750;750;750;750;0;0;0;0;0;900;NTHMedia_S
S_1441__NthChat                         ;2025-01-01;150;1178;176700;176700;94050;94050;82650;82650;0;0;0;112860;NTHMedia_S
S_1553_BAL_1553BAL                      ;2025-01-01;150;20;3000;3000;1650;1650;1350;1350;0;0;0;1980;NTHMedia_S
S_1553_ISTINA_1553ISTINA                ;2025-01-01;150;2;300;300;0;0;300;300;0;0;0;0;NTHMedia_S
S_1553_KUL_KUL                          ;2025-01-01;100;3;300;300;300;300;0;0;0;0;0;360;NTHMedia_S
S_1553_KZV_1553KZV                      ;2025-01-01;300;1772;531600;531600;363900;363900;167700;167700;0;0;0;436680;NTHMedia_S
S_1554_TKN_1554TKN                      ;2025-01-01;300;354;106200;106200;75300;75300;30900;30900;0;0;0;90360;NTHMedia_S
S_1554_VIA_1554VIA                      ;2025-01-01;600;497;298200;298200;260400;260400;37800;37800;0;0;0;312480;NTHMedia_S
S_1556_TAT1_1556TAT1                    ;2025-01-01;200;19;3800;3800;3400;3400;400;400;0;0;0;4080;NTHMedia_S
S_1556_TAT2_1556TAT2                    ;2025-01-01;300;228;68400;68400;33900;33900;34500;34500;0;0;0;40680;NTHMedia_S
S_1556_TLS1_1556TLS1                    ;2025-01-01;100;94;9400;9400;5000;5000;4400;4400;0;0;0;6000;NTHMedia_S
S_1556_TLS2_1556TLS2                    ;2025-01-01;150;3;450;450;300;300;150;150;0;0;0;360;NTHMedia_S
S_1556_TLS3_1556TLS3                    ;2025-01-01;200;56;11200;11200;7800;7800;3400;3400;0;0;0;9360;NTHMedia_S
S_1556_TLS4_1556TLS4                    ;2025-01-01;300;106;31800;31800;23100;23100;8700;8700;0;0;0;27720;NTHMedia_S
S_1556_TLS5_1556TLS5                    ;2025-01-01;150;82;12300;12300;11250;11250;1050;1050;0;0;0;13500;NTHMedia_S
S_1556_TLS6_1556TLS6                    ;2025-01-01;300;8;2400;2400;1500;1500;900;900;0;0;0;1800;NTHMedia_S
S_1556_TLS8_1556TLS8                    ;2025-01-01;580;2;1160;1160;580;580;580;580;0;0;0;696;NTHMedia_S
S_1617_SEX_1617SEX                      ;2025-01-01;750;58;43500;43500;32250;32250;11250;11250;0;0;0;38700;NTHMedia_S
S_1617_TIK_1617TIK                      ;2025-01-01;750;3;2250;2250;750;750;1500;1500;0;0;0;900;NTHMedia_S
S_1665_AN_1665An                        ;2025-01-01;300;1;300;300;300;300;0;0;0;0;0;360;NTHMedia_S
S_1665_LOVE_1665Love                    ;2025-01-01;300;1;300;300;300;300;0;0;0;0;0;360;NTHMedia_S
S_1665_SYM_1665SYM                      ;2025-01-01;450;9;4050;4050;2250;2250;1800;1800;0;0;0;2700;NTHMedia_S
S_1668_AKTIVIRAJ_1668AKTIVIRAJ          ;2025-01-01;1250;23;28750;28750;23750;23750;5000;5000;0;0;0;28500;NTHMedia_S
S_2778_ALL_2778ALL                      ;2025-01-01;500;10;5000;5000;500;500;4500;4500;0;0;0;600;NTHMedia_S
S_2778_ANDEO_2778ANDEO                  ;2025-01-01;450;260;117000;117000;88650;88650;28350;28350;0;0;0;106380;NTHMedia_S
S_2778_CODE_2778CODE                    ;2025-01-01;75;8;600;600;525;525;75;75;0;0;0;630;NTHMedia_S
S_2778_DAPA_2778DAPA                    ;2025-01-01;500;2;1000;1000;0;0;1000;1000;0;0;0;0;NTHMedia_S
S_2778_GO_2778GO                        ;2025-01-01;180;66;11880;11880;5940;5940;5940;5940;0;0;0;7128;NTHMedia_S
S_2778_KEY_2778KEY                      ;2025-01-01;400;6;2400;2400;2000;2000;400;400;0;0;0;2400;NTHMedia_S
S_2778_LEN_2778LEN                      ;2025-01-01;450;68;30600;30600;25200;25200;5400;5400;0;0;0;30240;NTHMedia_S
S_2778_PIN_2778PIN                      ;2025-01-01;800;23;18400;18400;7200;7200;11200;11200;0;0;0;8640;NTHMedia_S
S_2778_REKVIZIT_2778REKVIZIT            ;2025-01-01;75;114;8550;8550;7050;7050;1500;1500;0;0;0;8460;NTHMedia_S
S_4016_BLOCK_4016BLOCK                  ;2025-01-01;600;1;600;600;0;0;600;600;0;0;0;0;NTHMedia_S
S_4023_MILICA_4023MILICA                ;2025-01-01;250;15;3750;3750;3750;3750;0;0;0;0;0;4500;NTHMedia_S
S_4023_PEDJA_4023PEDJA                  ;2025-01-01;250;3;750;750;500;500;250;250;0;0;0;600;NTHMedia_S
S_4023_SAVET_4023SAVET                  ;2025-01-01;250;23;5750;5750;4000;4000;1750;1750;0;0;0;4800;NTHMedia_S
S_4505_APEX_4505APEX                    ;2025-01-01;800;932;745600;745600;539200;539200;206400;206400;0;0;0;647040;NTHMedia_S
S_4640_PCA_4640PCA                      ;2025-01-01;5;63;315;315;265;265;50;50;0;0;0;318;NTHMedia_S
S_4640_UCA_4640UCA                      ;2025-01-01;5;2;10;10;10;10;0;0;0;0;0;12;NTHMedia_S
S_4644_100_4644100                      ;2025-01-01;100;17;1700;1700;1000;1000;700;700;0;0;0;1200;NTHMedia_S
S_4644_150_4644150                      ;2025-01-01;150;17;2550;2550;1800;1800;750;750;0;0;0;2160;NTHMedia_S
S_4644_200_4644200                      ;2025-01-01;200;17;3400;3400;3000;3000;400;400;0;0;0;3600;NTHMedia_S
S_4644_300_4644300                      ;2025-01-01;300;11;3300;3300;2400;2400;900;900;0;0;0;2880;NTHMedia_S
S_4644_50_464450                        ;2025-01-01;50;12;600;600;250;250;350;350;0;0;0;300;NTHMedia_S
S_4644_GAME_4644GAME                    ;2025-01-01;50;3;150;150;50;50;100;100;0;0;0;60;NTHMedia_S
S_4644_GAME1_4644GAME1                  ;2025-01-01;100;3;300;300;200;200;100;100;0;0;0;240;NTHMedia_S
S_4644_GAME2_4644GAME2                  ;2025-01-01;150;468;70200;70200;61500;61500;8700;8700;0;0;0;73800;NTHMedia_S
S_4644_GAME3_4644GAME3                  ;2025-01-01;200;1;200;200;200;200;0;0;0;0;0;240;NTHMedia_S
S_4644_GAME4_4644GAME4                  ;2025-01-01;300;2;600;600;600;600;0;0;0;0;0;720;NTHMedia_S
S_4644_MAD_4644MAD                      ;2025-01-01;580;2;1160;1160;0;0;1160;1160;0;0;0;0;NTHMedia_S
S_4644_MAT_4644MAT                      ;2025-01-01;580;57;33060;33060;10440;10440;22620;22620;0;0;0;12528;NTHMedia_S
S_4644_TXT_4644TXT                      ;2025-01-01;800;15;12000;12000;6400;6400;5600;5600;0;0;0;7680;NTHMedia_S
S_5232_SLA_5232SLA                      ;2025-01-01;150;1063;159450;159450;116700;116700;42750;42750;0;0;0;140040;NTHMedia_S
S_5232_SLA1_5232SLA1                    ;2025-01-01;200;478;95600;95600;69400;69400;26200;26200;0;0;0;83280;NTHMedia_S
S_5232_SLA2_5232SLA2                    ;2025-01-01;300;296;88800;88800;56700;56700;32100;32100;0;0;0;68040;NTHMedia_S
S_5232_SLA3_5232SLA3                    ;2025-01-01;580;97;56260;56260;34220;34220;22040;22040;0;0;0;41064;NTHMedia_S
S_5232_SLA4_5232SLA4                    ;2025-01-01;800;46;36800;36800;28000;28000;8800;8800;0;0;0;33600;NTHMedia_S
S_5332_RATE_5332SmsRateUnicredit        ;2025-01-01;6;3039;18234;18234;14310;14310;3924;3924;0;0;0;17172;NTHMedia_S
S_5332_STA_5332UnicreditUpitStanja      ;2025-01-01;6;1277;7662;7662;6072;6072;1590;1590;0;0;0;7286.4;NTHMedia_S
S_7008_TAROT247_NTHTarot247             ;2025-01-01;50;43;2150;2150;2150;2150;0;0;0;0;0;2580;NTHMedia_S
